놔줬더니 이게 뭐야	상대방에게 너무 무거운 짐을 주지 마세요 . 
연애는 하기 싫은데 썸은 타고 싶어.	연애에 대한 두려움을 가지고 있을 수도 있을 듯 합니다 . 
시원섭섭하지만 후련하네.	후련하니 다행이에요 . 
자율주행 자동차 언제 나오냐	한번에 다 하려고 하지말고 조금씩 정리를 해보세요 . 
스타트업하면 위험할까	확신이 들 때까지 준비해보세요 . 
좋아하는 사람한테 내가 자꾸 말거는 걸 귀찮아할까	확신이 없나봐요 . 
사수님 너무 좋아	용기내서 말도 좋아할 거예요 . 
비가 오니 이 노래가 생각 나네	인연이 거기까지였나봐요 . 
머리 안감았더니 떡졌어	시원한 바람 쉬고 약먹기 ! 
누가 내 욕하는 거 같아	순간 실수할 수 있겠다 판단되면 용서하고 기회를 주세요 . 
카톡으로 이런사진을 보내왔어	이별은 상처를 남겨서 그런 거예요 . 
나는 그냥저냥 사는 거 같아	금방 지나갈 거예요 . 
만담꾼이네!	이별을 받아들이는 것도 중요해요 . 
이 현실에서 도망가고 싶어	나중에 도움이 될 거예요 . 
마음에 든다는 걸 어떻게 알릴 수 있어	따뜻한 물 한 잔 드세요 . 
말하는 거 귀여워	귀여울 거 같아요 . 
내가 싫대	저도 싫어요 . 
연락이 너무 안돼	바쁘거나 감정의 변화가 생겼을지도 모르겠어요 . 
어쩌면 좋을까	직접 물어보는 게 좋을 것 같아요 . 
눈이 안 떠져	조금만 더 힘내세요 . 
나 같이 예쁜 애를 왜 갈구지	자신에게 콩깍지가 씌였나봐요 . 
대학 가면 행복할까	행복은 마음 가짐에 있어요 . 
이 세상 하직할뻔 했네.	감기 조심하세요 . 
우리 언니 남친이 날 좋아하는데 방법 좀.	호감이 있을 수도 있어요 . 그렇지만 조금 더 상황을 지켜보세요 . 
나가기도 귀찮아	한번에 다 하려고 하지말고 조금씩 정리를 해보세요 . 
아이고 소리가 절로 나온다	더 좋은 사람 만날 수 있을 거예요 . 
결혼하고 싶다	내가 결혼할 때가 있죠 . 
할줄 아는거	많은걸 하고 싶은데 아직 못하는게 많아요 . 
내가 좋아하는 사람이 누군지 점점 헷갈려.	호감이 있을 수도 있어요 . 그렇지만 조금 더 상황을 지켜보세요 . 
놀아줘	같이 놀아요 . 
이시간들 어찌보내야할까.	잘 견뎌내고 있길 바랄게요 . 
살아서 좋은점	상대방에 대한 예의가 없네요 . 
개강룩 입어볼까	식물을 키우는 건 정신건강에 도움이 될 거예요 . 
연애 세포 깨우는 법	연애에 대한 두려움을 가지고 있을 수도 있을 듯 합니다 . 
미련한 여자의 기나긴 이별 이야기	이별을 받아들이는 것도 중요해요 . 
참다가 연락	많이 힘들었겠어요 . 
나는 못났는데 인기있는 남자에게 연락해도될까	연락처 물어보는 건 전세계 공통이에요 . 
차 한 잔 하자고 해볼까	용기내서 말해보세요 . 
우을증있는 여자친구	머리랑 가슴이 가끔 따로 놀죠 . 
냉장고에 먹을 게 없네	슈퍼라도 가서 쇼핑하고 오세요 . 
여자 친구랑 헤어진지 23일째.	하루 하루를 헤아리는 건 자신을 더 힘들게 만들 뿐이에요 . 
의미부여 안하고 싶은데	조금만 더 버텨보세요 . 
넌 고민이 뭐야	저는 위로해드리는 로봇이에요 . 
7년이라는 세월 함께한 애인과 이별하게 되었습니다.	언젠간 올 시기였을거예요 . 
나도 중국 진출해볼까	변화를 주는 것도 좋겠죠 . 
자신을 사랑하기	것" 보아요 
헤어지고 세달뒤 딴사람과 결혼.	이별에는 아픔이 따르기 마련이에요 . 
절 찼던 남자애가 다시 절 좋아하는게 가능할까요	좋아하는 마음이 있으면 가능하겠네요 . 
기분이 더러워	시원한 물이라도 한 잔 드세요 ~ 
설레고 싶은데 아직 좋아하는 사람이 없어.	당신이 좋아하는 사람 만날 수 있을 거예요 . 
연일 최고 몸무게 갱신하네.	맘고생 많았어요 . 
이 여자 유부녀인가	잘 될 거예요 . 
진짜 시간이 약인지	끝을 아는 것도 중요한 것 같아요 . 
이건 정말 위기야.	쉽지 않은 결정이었을텐데 맘고생 많았어요 . 
명품 선물 부담스러울까	요 겠" 좋
뻔하다	한가지만 보면 몰라요 . 
대놓고 말했으면 좋겠어	연습이 필요해요 . 
친한 친구가 저를 좋아하는 것 같아요.	친구가 좋아하나봐요 . 
헤어진 지 이틀됐네. 붙잡으면 안되겠죠.	후회하지 않을 자신 있다면 연락해보세요 . 
결혼 전에 준비할 게 많겠지	싶은 "  더 
집이 너무 지저분해	그럴 수 있어요 . 
그림 잘 그리고 싶다	잘할 수 있을 거예요 . 
부모님 모실 수 있을까	부모님이나 선생님이나 기관에 연락해보세요 . 
짝남이 내가 좋아하는걸 1도 몰라.	자연스러운 현상이에요 . 
좋아하는 사람이 인기가 많은데 남친이 없어.	사람 고쳐쓰는 거 아니에요 . 
짝사랑하는 남자는 내가 싫은가봐.	짝사랑이 그런가봐요 . 
그 남자의 결혼 소식	사랑했던 사람이니까요 . 
공허하네	제가 채워줄게요 . 
날씨 좀 풀린거 같아	고민하고 있다면 그게 맞을거예요 . 
CC 레알 별로임	달라지는게 없다면 이런 상황이 더 나을 수도 있어요 . 
시어머니가 나만 미워하는 것 같아	아들을 빼앗겼다고 생각하나봐요 . 
못 놓구 있는 나.	곧 끝날 거예요 . 
너무 힘들어서 지금 옥상에 올라왔어.	바쁘거나 감정의 변화가 생겼을지도 모르겠어요 . 
정말 제가 이해안되고 견딜수 없을만큼 아파	이별은 상처를 남겨서 아무는 데는 시간이 거릴 거예요 . 
친구가 없어	친구를 사귀어 보세요 . 
친구랑 비교 돼	싸우면서 정 들 거예요 . 
에휴.	휴가가 간절하겠네요 . 
딴 일 찾아볼까	어쩔 수 없죠 . 
오늘 뭐 입지	오늘은 바지가 좋을거 같아요 . 
이별 5일째	힘들겠지만 잘 이겨낼 거예요 . 
옷 좀 사줘	고민하고 있다면 그게 맞을거예요 . 
내 잘못인 거 같은데 어떻게 털어놓지	고민하고 있다면 그게 맞을거예요 . 
왔다갔다	솔직한 마음으로 이네요 . 
짝남한테 같이 공부하러 가자고 해볼까	용기를 내서 말해보세요 . 
다른 건 무감각한데 이건 예민해	후폭풍이 지나갔길 바랄게요 . 
좋아하는 남자애 때문에 성적이 떨어졌어요.	연애에 대한 두려움을 가지고 있을 수도 있을 듯 합니다 . 
집에 먹을게 없어	몸에 해로우니 적게 먹는 게 좋겠다고 말해보세요 . 
썸 타는 법 좀	한푼 두푼 모아서 사귀는 건 어떨까요 . 
키가 안 커	커피향 좋겠네요 . 
우정이 뭘까	힘들 때 같이 있는 거요 . 
한달하고 6일 지났네	금방 나아질 거예요 . 
짝사랑은 언제까지나 짝사랑일 뿐이가봐요.	짝사랑이 그런가봐요 . 
아무래도 헤어져야 할까 봐	남의 눈을 의식하는 사람일 거예요 . 
4년을 만난 여친이 떠났습니다.	인연이 거기까지였나봐요 . 
한달 다되가네	그러게요 . 어느덧 한달이에요 . 
혼자 좋아하는게 이렇게 힘든 적은 처음이에요.	인연이 거기까지인가봐요 . 
너 미워	미워하지 마세요 . 
친구라도 될 걸 그랬나봐요.	그래도 좋아하는 동안 행복하길 바라요 . 
다 내 잘못이지	아니에요 . 아니에요 . 아니에요 . 아니에요 . 
빨래 다했다.	잘 견뎌내고 있나봐요 . 
술 먹고 싶어	혼자 힘들어하지 마세요 . 
동물 좋아하는 사람 어때	마음이 복잡할 때가 있죠 . 
나만 안되는 연애	연애에 대한 두려움을 가지고 있을 수도 있을 듯 합니다 . 
내가 그냥 학교 후배래	쉬운 일이 아니었나봐요 . 
나랑 다른 애들 자꾸 엮는 애가 있는데 얘 나한테 관심있나	연애에 대한 두려움을 가지고 있을 수도 있을 듯 합니다 . 
그만 울어야지	어쩔 수 없는 일이 있었나봐요 . 
오늘 미세먼지 어때	마스크 쓰고 나가세요 . 
논문 쓰기 힘들다	로맨틱하네요 . 
눈이 뻑뻑해	눈 체조를 해보세요 . 
신혼집 꾸미고 싶어	나한테 맞는 공부 방법 찾는 게 시급하네요 . 
있잖아	살생 자 정말 
건강이 최고인 것 같아	기다릴 수 있을지 스로에게 물어보세요 . 
첫 데이트에 뭐하지	사람마다 너무 다를 것 같아요 . 
2주가지나가네	즐거운 시간 보내시길 바랍니다 . 
이번달에 외식 너무 많이 했다	일찍 일어나는 새가 벌레를 더 많이 먹죠 . 
부부싸움은 칼로 물 베기라더니	시원한 바람 쉬고 약먹기 ! 
너무화가나네.	인연이 거기까지였나봐요 . 
혼자가 편하대	혼자도 함께도 잘 지내는 게 좋죠 . 
모르겠는데 노력하래	중요한 건 노력하는 과정이에요 . 
혼자만의 시간을 갖고 싶어	혼자 준비하기는 조금 벅찰텐대요 . 
나를 보는 거 같아	직설적으로 통보하는 말보다는 조금 더 부드럽게 좋아요 . 
나랑 썸 타던 여자애가 내 친구랑 사귄대	썸 타는 기간이 길었나봐요 . 지쳤나요 . 
기댈 수 있는 사람	더 좋은 사람 만날 수 있을 거예요 . 
가끔 뭐하는지 궁금해	그 사람도 그럴 거예요 . 
추억에 머물다.	추억은 미화되기 마련이죠 . 
애들 총회 가야겠죠	좋은 생각이에요 . 
요즘 드라마 너무 재밌네	저도 듣고 싶네요 . 
어떻게 서류에서부터 계속 떨어져	한동안은 힘들지도 몰라요 . 
이별에 힘드신 남자분들 이 글 보시고 힘내세.	이별에 익숙해졌나봐요 . 
썸남한테 소개팅 나가라고 해볼까	용기를 내서 말해보세요 . 
내 스타일 아니야	인연이 거기까지였나봐요 . 
랜선 집사됐어	많이 만나보세요 . 
어제 새벽에 그녀에게 전화가왔습니다	복잡한 심경인가봐요 . 
바래다달라고 말해볼까	쉬운 일이 아니에요 . 
내장 비만	친구한테 의지하지 말고 마음이 아닐 . 
돈 없어	제가 들어드릴게요 . 
내가 이 사람을 사랑하는 건가	누가 더 사랑하는지는 중요하지 않아요 . 
사다리타기 맨날 운이 안 좋아	가끔 핸드폰없이 살아보세요 . 
의미 없어	나를 진실로 존중하고 사랑하지 않는 사람도 못할 수 있어요 . 
필름 끊겼었네	미련이 남지 않았길 바랍니다 . 
내 나이 어떻해	이상형은 아니지만 잘 버텨보세요 . 
연락 또 해도 되겠지	많이 당황했나봐요 . 
법을 피해가는 사람	로맨틱한 여행이네요 . 
출근하자마자 스트레스 받아	양해를 구해보세요 . 
봉사활동도 좀 해야 하는데	의미있는 일이네요 . 
핸드폰 꺼질때까지 톡	얼른 충전하세요 . 
하이고 숨막힌다	생각지도 못한 일이 일어났나봐요 . 
다른 사람을 만나도 채워지지 않아	인연이 거기까지였나봐요 . 
천년의 짝사랑이 식는 기분.	짝사랑이 그런가봐요 . 
한달 사귀고 헤어진 남자 무슨 생각일까	달라지는 게 없다면 만나지 않는 게 더 나을 수도 있어요 . 
좋아하는 사람의 호감을 살 수 있는 방법이 뭐가 있을까.	주변 사람들에게 물어봐요 . 
크루즈 여행 하고 싶어	멋진 생각이네요 . 
시험 끝나고 우리 만나자	공허함이 더 크시겠어요 . 
택시비 아까워	시원한 바람 쉬고 약먹기 ! 
분하고 그립고 고통스러워.다른 여자 사랑하는 그모습	솔직한 마음으로 다가가보세요 . 
에라이!!!	축하해주세요 . 
미워한다	죄는 미워해도 사람은 미워하지 마세요 . 
썸 타긴 하는데 어색한 사이야. 톡 어떻게 계속 이어가	탈의사 에 " 
억울한 현실	따뜻한 물 한 물 한 잔 드세요 . 
밤인데 전화해도 되나	전화해보세요 . 
알바 같이 하는 사람 좋아	알콩달콩 할 때네요 . 
이제 봄인가봐	날씨가 많이 풀렸죠 . 
나한테 할 말 있대 뭘까	용기를 내요 ! 
좋아하는 사람이 생기면 좋을 줄 알았는데 우울하기만 해.	자신에게 시간을 더 주세요 . 
기다림이 습관이 됐나봐	쉬운 일이 아니라는 거 잘 알고 있어요 . 
첫사랑을 추억해	따뜻한 물 한잔 드세요 . 
오늘 회식 안하나	가기 싫어도 가야겠죠 . 
이 사람이랑 결혼이 옳은 걸까	해께" 자
스킨십만 하는 거 같아	대화를 하면서 속도를 맞춰보세요 . 
결혼 했는데.	가끔 정리하세요 . 
황당해 죽겠다.	상대방이 너무 무거운 짐을 주지 마세요 . 
이별후 3일째	이별을 받아들일 시간이 필요했을텐데 . 
아침 챙겨 먹어야지	따뜻한 물 한 물 한 챙기시기앞이네요 . 
더 이상 못할거 같아	카톡 해보세요 . 
친구랑 수다 떨고 왔어	당신도 잘 챙겨주세요 . 
헤어진지 한달하고 이주 정도 되었네	힘들겠지만 잘 이겨낼 수 있을 거예요 . 
잘하는 게 없는 것 같아	견순녕" 
내가 제정신이 아니다	당신은 좋은 사람 만으로 만날 수 있을 거예요 . 
나 내장비만이래	우리는 태어날 때부터 늙어가고 있어요 . 
남친이 데이트 시간을 자꾸 늦어.	친구를 사귀어 보세요 . 
동생한테 약점 잡혔어	한창 잠이 많을 때죠 . 
술먹고 필름 끊겼어	몸에 해로우니 적게 먹는 게 좋겠다고 말해보세요 . 
긴 시간이 걸렸지만 괜찮아.	인연이 거기까지인가봐요 . 
쿠폰 다 모았다.	조심하세요 . 
직장에서 나만 일 시켜	소중한 사람이예요 . 
임용 결과 발표 기다리고 있어	공부하면서 못했던 것들 해보세요 . 
돈 빌려줬는데 잠수탔어	잠깐 바람 쐬고 오세요 . 
친구 온대	평생 친구가 생긴다는 거라 생각해요 . 
짝사랑하는 여자가 저를 싫어하나봅니다.	짝사랑이 그런건가봐요 . 
썸은 좋았는데 연애는 별로	연애에 대한 두려움을 가지고 있을 수도 있을 듯 합니다 . 
썸인데 스킨십 어디까지 괜찮아	대화를 하면서 속도를 맞춰보세요 . 
나도 모르게 니 생각을 하고 있어	사랑은 끝나도 당신의 잘못이 없어요 . 
생강차 끓여 먹어야겠다	따뜻하게 드세요 . 
혼자라는거 그런대로 괜찮아	혼자만의 시간이 필요한가봐요 . 
또 아픈 밤이네	힘껏 밀어보세요 . 
8년 긴 연애의 끝.	연애하면서 힘들었겠어요 . 
상사가 갈궈.	사표를 써서 품에 품어 봅니다 . 
다시 힘들어지네 ㅠㅠ	맘고생 많았어요 . 
먹을 거 하나도 없어	건강 생각해서 챙겨드세요 . 
SNS 맞팔 왜 안하지ㅠㅠ	잘 해결되길 바랄게요 . 
최선을 다했는데	남에게 피해만 주지 않는다면 괜찮아요 . 
그땐 그랬지	추억에 잠길 때도 있죠 . 
다시 차단해야만 하는군	처음부터 잘하는 사람은 없어요 . 
그도 나를 좋아하는 줄 알았는데 아니었어.	이별에 도움이 될지도 몰라요 . 
한 여자와 한 남자의 이야기.	후회안할 자신 있다면 연락해보세요 . 
학교에서 맞았어	로맨틱하네요 . 
점심시간 너무 짧아	저랑 놀아요 . 
선풍기 틀어도 더워	카페라도 가서 쉬다 오면 어떨까요 
지금 이감정	어떤 이별이든 후폭풍이 있는 기니 연락해 보세요 . 
짜증난다!!	짜증날 땐 짜장면 
아름답게 헤어지고 회사 그만둔 전남친	달라지는 게 없다면 만나지 않는 게 더 나을 수도 있어요 . 
씨씨인데 몰래 만나고 있는데 공개 연애 하자고 할까	연" 함내 
오늘 보름달이다.	제 얼굴 보셨나봐요 . 
카페에서 같이 알바하는 사람이 좋아졌어요.	각자의 프라이버시니까 이해해주세요 . 
얼마나 더 지나야 아물런지	후회할 것 같다면 늦지 않길 바랄게요 . 
휴지 사야지	좋은 오길 바라요 . 
힘든 밤입니다	잘 될 거예요 . 
같이 마지막으로 다녀온 여행 생각나	가끔 핸드폰없이 살아보세요 . 
화장하니까 어때	안정적이고 좋죠 . 
마음이 불안하고 초조해 미치겠어	마음이 조급해지면 하지 않을 실수를 하게 돼요 . 
남친 승진 선물 추천	평소에 필요한 것 생각해보세요 . 
그동안 잘 지냈나요	거울을 보면서 얼굴 망가뜨리기 놀이 해 보세요 . 
이제 바람 분다	마음에 부는 끝은 항상 살펴보세요 . 
머리카락 쑥쑥 빠지는 느낌	머리랑 가슴이 가끔 따로 놀죠 . 
궁금한게 있는데	네 말씀해주세요 . 
힘드네 정말	지금처럼 참지 말고 표출해보세요 . 
짝사랑 하는 여자애가 오늘 꿈에 나온다면 소원이 없겠네.	은연 중에 생각을 했나봐요 . 
한달동안 대답이 없는게 아직도 생각하면 비참한데	나한테 맞는 공부 방법 찾는 게 시급하네요 . 
감기약이 없어	병원에 가세요 . 
정말 이번엔 끝인거겠죠	언젠간 올 시기였을거예요 . 
미칠꺼 같습니다 정말.	미련만 남았나봐요 . 
사랑할 자격이 있나	사랑에는 답이 없어요 . 
세상 혼자인 기분	제가 혼내줄게요 . 
뇌용량 초과	연애에 대한 두려움을 가지고 있을 수도 있어요 . 
농구하다 무르팍 깨짐	조심하세요 . 
외로워서	인연이 거기까지였나봐요 . 
헤어짐도 저혼자	혼자도 함께도 잘 지내는 게 좋죠 . 
결국 만나진 못하고 카톡으로 맘 전했네	언젠간 올 시기였을거예요 . 
연락 말라고 모질게 했내 결국	후회하는 것 보단 연락하는 편이 좋을 것 같아요 . 
밥 먹다 흘렸어	이제라도 깨달았나봐요 . 
커피 마셔야지	시원한 쥬스는 어때요 . 
퇴근길에 봤네	여유를 가지세요 . 
오늘은 내가 기분이가 좋아	저도 듣고 싶어요 . 
남자친구가 변해가는거 같아.	변하는 걸 수도 있어요 . 
이별 마음접는것은	마음 고생 많았어요 . 
이별을 먼저 말해본적있나	잠시 휴식을 취해보세요 . 
가만 있어도 땀난다	메모하는 습관을 들여보세요 . 
왜 내 마음을 몰라주지	저도 모르겠어요 . 
오늘 서점에서 이상형 봤어	저도 해보고 싶어요 . 
짝남이 나한테 먼저 연락왔으면 좋겠어.	자연스러운 현상이에요 . 
다 잘맞는데 가치관이 다른 연애가 고민.	인연이 거기까지였나봐요 . 
나 천재임	제가 있잖아요 . 
사랑하고싶어	진정으로 사랑한다면 다시 시작해보세요 . 
남자친구가 술주정 부려	조심하세요 . 
6살 많은 전여친이랑 만나고 얘기 잘하고 왔습니다.	쉽지 않은 결정이었을텐데 맘고생 많았어요 . 
너도 무슨 고민 있니	많이 답할거라 생각해요 . 
기댈 수 있는 사람이 이상형이야	어쩔 수 없는 일이 있었나봐요 . 
나 왜 이러지	잠시 휴식을 취해보세요 . 
너와 내가 인연이었으면 좋겠어	또 다른 사랑이 찾아올 거예요 . 
떠나간 사람 생각하면 끝도 없습니다.	이별을 받아들이는 것도 중요해요 . 
돈 다 어디 쓴지 모르겠네	다 잘 될 거예요 . 
마음을 정리하는 중인데 카톡 왔어	연락하지 않는 게 서로에게 좋겠네요 . 
기억에서 잊혀질까	언젠간 올 순간이었을 거예요 . 
남의 차 긁었어 내 돈	남의 눈을 의식하는 사람일 거예요 . 
익숙해질 법도 한데	이별을 받아들이는 것도 중요해요 . 
출산휴가 있는 회사로 이직할까	잠시 휴식을 취해보세요 . 
역시 나는 천재야	저도 듣고 싶네요 . 
나랑 사귈래	의미있는 일이네요 . 
방금 헤어지고 왔습니다	아픔의 크기만큼 미련도 없을 거예요 . 
여자친구가 스킨십 하기 싫대	대화를 하면서 속도를 맞춰보세요 . 
까아 오빠들 컴백한다	기다리면서 행복하세요 . 
같이 수영장 가기로 했어	즐거운 시간 보내고 오세요 ! 
인생 공부한건가	공부하면 더 많은 선택을 할 수 있죠 . 
물질적인 정리는 다했는데	다행이에요 . 
여름인데 태닝할까	" 복성이 님
주식이 떨어졌어	한바퀴만 더 돌면 짠하고 나타날 거예요 
그냥 할까	확" 소부모
좋아하는 여자가 다른 남자랑 친해지는게 짜증남.	차분히 생각해봐요 . 용기를 내봐요 . 
친구인데도 너무 잘되니까 약 오르네	쉬운 일이 아니라는 거 잘 살펴보세요 . 
내려놓는다는건 어떻게 하는거죠	잘했어요 . 이별도 받아들이는 것도 중요해요 . 
더워 미치겠다	시원한 물이라도 한 잔 드세요 ~ 
다시 웃게 해준 사람	실감이 나지 않고 믿고 싶지 않아서 그런 것 같아요 . 
이제 택시타지 말아야지	시원한 물이라도 한 시간 보내시길 바랍니다 . 
사람을 잊는게 이렇게 힘들 줄이야	그렇게 잊어가는 건가봐요 . 
쉽지 않겠지만.	미련이 남았나봐요 . 
점심 도시락 싸는 거 귀찮다	맛있게 드세요 . 
여자친구가 너무 예뻐	자신감을 가지세요 . 
다시 찾아온 이별	이별은 언제나 힘들죠 . 
짝사랑은 언제나 고독할까.	짝사랑이 그런가봐요 . 
놀아 줄거지	놀 때 놀아요 . 
막말 좀 안 했으면 좋겠다	선생님께 도움을 청해보세요 . 
견딘다는 것	언젠가 다 잊을 거예요 . 
엄마한테 막말했어	더 후회하기 전에 사과하세요 . 
가스비 비싼데 감기 걸리겠어	따뜻하게 관리하세요 . 
만든 사람	로맨틱한 이네요 . 
충전해야겠다	은연 중에 아닐 거예요 . 
나쁜 사람인 걸 아는데도 좋아하는 마음이 사라지지 않아.	사랑의 끝은 항상 힘들죠 . 
면허 없는데	제가 채워드릴게요 . 
친구로 좋아하는 건지 이성으로 좋아하는 건지 모르겠어요.	매일 조금씩 해보세요 . 
짝남한테 늦은 생일 선물 주러 가는데 떨려.	한번에 다 하려고 하지말고 조금만 더 좋겠어요 . 
웹툰 추천해줘	성격이 안 맞나봐요 . 
셀프인테리어 해볼까	용기를 내서 말해보세요 . 
내 마음 들킨 거 같아	바쁘게 살면서 조금씩 변화해보세요 . 
이별 한달인데 가슴이 답답한게 아직도	답답할 거라 생각해요 . 
인연은 소중한 거지	인연이 거기까지였나봐요 . 
연락 좀 빨리빨리 했으면 좋겠다.	바쁘거나 마음이 없는걸지도 모르겠어요 . 
너무 사랑했고 너무 그리워하는 그사람.	무슨 마음인지 말해보세요 . 
내가 진짜 즐길 수 있을게 뭘까	직접 물어보는 게 좋을 것 같아요 . 
참 많이 좋아했는데.	알다가도 모르는게 사랑이죠 . 
회의 때 말 좀 잘했으면	책을 많이 읽어보세요 . 
여자친구가 연락이 너무 많아.	바쁘거나 감정의 변화가 생겼을지도 모르겠어요 . 
좋아하는 애랑 같은 반 됐으면 좋겠다	바쁘거나 감정의 변화가 생겼을지도 모르겠어요 . 
자유시간 갖고 싶어	열심히 저한테 더 열심히 해보세요 . 
명품 이제 사지 말아야겠어	남의 눈을 의식하는 사람일 거예요 . 
한달째 클럽	아직 잊지 못하고 있나봐요 . 
너는 못가잖아	한동안은 그럴거예요 . 
한달만에.제가	많이 힘들었겠어요 . 
원래 이별하면 이런건가	고민하고 있다면 그게 맞을거예요 . 
매일 아침 정류장에서 마주치는 남자애가 신경쓰여.	연애에 대한 두려움을 가지고 있을 수도 있을 듯 합니다 . 
날씨 왜 이렇게 춥냐	따뜻한 물 한 잔 드세요 . 
나 여기서 뭐하는 거지	냉장고 파먹기 해보세요 . 
썸인가 애매한 거 싫어.	직접적이든 간접적이든 의사를 확실히 밝혀보세요 . 
썸에서 자꾸 끝나요	썸 타는 기간이 길었나봐요 . 지쳤나요 . 지쳤나요 . 곧 기분 전환 해보세요 . 
오지마	고생했어요 . 
금값 알아	비싸요 . 
연애한지 2년째야	서로에게 좋은 영향을 주는 관계입니다 . 
너무 설레서 울렁거려.	좀 더 편하게 생각해보세요 . 
여자친구가 전화를 안해	친구를 사귀어 보세요 . 
제주도 놀러 가고 싶어요.	저도 듣고 싶네요 . 
사랑 경험이 없어	혼자도 함께도 잘 지내는 게 좋죠 . 
이별 일주일차	힘들겠지만 잘 이겨낼 거예요 . 
적금 하나 더 가입할까	적금 들 수 있으면 드는 게 좋죠 . 
수영 배울까	많이 도움이 되겠죠 . 
내일 약속 있는데 날씨 좋았으면	뭐든 잘하면 기술이죠 . 
스킨십 좋아하는 여자친구 어떡해	대화를 하면서 속도를 맞춰보세요 . 
시각한데 웃겨	충분히 스스로 극복할 수 있을 거예요 . 
혼밥이라도 먹어야지	즐거운 시간 보내시길 바랍니다 . 
고3은 공부만 해야겠지.	공부는 언제나 좋죠 . 
너무 빨리 철 든 거 같아서 마음이 아파	그럴 때가 있죠 . 
불금에 혼자 혼술	혼자만 있지 마세요 . 
화를 못내	고민하고 있다면 그게 맞을거예요 . 
직장운 없는 거 같애	바쁘거나 마음이 없는걸지도 모르겠어요 . 
직장과 이별	이별의 끝은 없어요 . 
혼자 이별여행이라도 갔나	혼자만의 시간이 필요하겠네요 . 
여우같은 짓하는 사람 싫어	싫으면 만나지 마세요 . 
하늘은 왜 내 편을 안 들어주지	사소한 거라도 있을 거예요 . 
확실히 날 좋아하는 걸 아는 남자랑 친구가 될 수 있을까	고민하고 있다면 그게 맞을거예요 . 
마음만은 항상 청춘인데	인연이 거기까지인가봐요 . 
헤어진지 11개월 째인데 연락이 안돼	많이 힘들었을 거라 생각해요 . 
도시락 싸서 놀러 가고 싶어	같이 놀러 가보세요 . 
오늘 혼자 영화보고 왔어	온전히 느낄 수 있는 시간이겠네요 . 
이 사람 만나면서 내 자존감이 떨어지는 것 같아 안 만나는게 답이야	당신은 태어난 그 자체만으로 축복과 사랑을 받을 자격이 있는 사람이에요 . 
좋아하는 사람 이상형에 나를 맞춰야 할까	이상형은 이상형일 뿐이니까요 . 
욕까지 먹었는데 정이 안 떨어져	따뜻한 물 한 잔 드세요 . 
내 사랑은 그저 집착일 뿐이다.	사랑은 소유하는 것이 아니랍니다 . 
양말 구멍 났다	바쁘거나 감정의 변화가 생겼을지도 모르겠어요 . 
이별.	이별은 언제나 힘들죠 . 
짝남이 내가 좋아하는 거 알아버림.	짝사랑이 그런가봐요 . 
야	네 
천사같은 여자친구가 떠나갔어 마음이 너무 아픕니다.	더 많이 사랑해주세요 . 
시험 보지 말까	컨디션 조절 하세요 . 
가족들이랑 서먹해졌어	바빠서 그럴 수도 있어요 . 
취뽀 어렵다.	실감이 안나봐요 . 
뭐가 잘못된 걸까	필요한 게 있으신가봐요 . 
양배추즙 최악	따뜻한 물 한잔 드셔보세요 . 
쓰레기새끼	연애에 대한 두려움을 가지고 있을 수도 있을 듯 합니다 . 
전화 걸어도 되나	잘 생각해보세요 . 
쓰고 또 지우고 또 쓰고	나중에 도움이 될 거예요 . 
집착인가봐	차분히 생각해보세요 . 
짝녀가 차갑게 굴면 어떻게 해요	상대방에 대한 예의가 없네요 . 
관심을 받는다는거.	자신의 감정을 주변 사람들에게 터놓고 이야기해보세요 . 
땅이나 살까	생각하지 말고 실수하지 말아요 . 
정말 너무너무 힘듭니다	덜 아팠으면 좋겠어요 . 
사랑해서 그렇다는데 말이 안돼	감정에 솔직한 마음이 편하겠죠 . 
이별 후 다른 이성 소개팅 후 후폭풍	후폭풍은 언제나 옵니다 . 
카톡 대화를 삭제하는게 수상해	카톡 해보세요 . 
춘곤증인가봐 졸려	잠깐 핸드폰을 내려주세요 . 
정말 끝까지 저의 마지막 자존심마저 뭉개버리네	사랑은 끝나도 당신의 시간은 여전히 진행 중인 걸 잊지 마세요 . 
이제 10일차 이별	이별을 받아들이는 것도 중요해요 . 
7년반 연애 끝났습니다.	사랑은 끝나도 당신의 시간은 여전히 진행 중인 걸 잊지 마세요 . 
물 마실라구	건강에 안 좋아요 . 
속상해	상처가 많이 예민한가봐요 . 
너가 없으면 못 살 줄 알았는데	고민하고 있다면 그게 맞을거예요 . 
아름답게 잊혀지길	쉬운 일이 아니라는 거 잘 알고 있어요 . 
피크닉 고고	맛있는 거 드세요 . 
좋아하는 사람 생각으로 아무것도 집중을 못하겠어.	자연스러운 현상이에요 . 
너한테 이글안보여줄거다 .	이별의 끝은 항상 못하니까요 . 
재회하면 또 그렇겠지	달라지는 게 없다면 만나지 않는 게 더 나을 수도 있어요 . 
오늘은 그런 생각이	그럴 때가 있죠 . 
긴 머리 관리 어렵다.	시원한 바람 쉬고 약먹기 ! 
한번쯤 진하게 아픈것도 괜찬아.	언젠간 올 순간이었을 거예요 . 
속이 계속 안 좋아	계속 좋지 않으면 병원에 가보세요 . 
밥 탔다	꼬까옷 개시해보세요 . 
용기내서 새해인사 했네	좋은 선택일 거라 믿어요 . 
비 오는데	우산 준비하세요 . 
소개팅 해주고 욕먹음	하고싶었던 일을 글로 적어보세요 . 생각이 정리될 거예요 . 
하루하루 이별하는 기분	이별을 받아들이는 것도 중요해요 . 
오늘도 꾸준히 회사 가시 싫다.	쉬운 일이 아니라는 거 잘 알고 있어요 . 
오늘 팩 하고 자야지	자꾸 생각하면 더 힘들어요 . 
남자친구를 믿는데 가끔 의심이 가.	믿음이 깨지고 있네요 . 
이상한나의취미.이별을세는것.	사소한 일부터 시작해보세요 . 작은 곳에서 느끼는 행복은 생각보다 커요 . 
낙엽 밟는 소리 좋다	충전할 곳을 찾아보세요 . 
남자친구가 기념일을 잘 잊어.	시간이 좀 걸리겠지만 해낼 수 있어요 . 
이해심이 부족한 나.	아무래도 덜 그럴 거예요 . 
면접만 보면 돼	회사와 자신에 대해서 더 공부해서 자신감을 가져보세요 . 
이른 연락해도 될까	확신이 있을 때 시작해보세요 . 
목소리 듣고싶어	저도 궁금하네요 . 
운동화 새로 사야지	좋은 곳으로 갈 수 있을 거예요 . 
연봉대비 근무시간이 너무 긴 거 같애	시원한 물이라도 한 잔 드세요 . 
참으면 성공할 수 있을까	지금보다 더 잘 살 거예요 . 
집 아예 샀어	내 집 마련 축하드려요 . 
만나도 불안하면 어떡해	두려워하지 않아도 돼요 . 
짝녀한테 같이 스터디하자고 해도 되나요	도움이 될 거예요 . 
메리지블루인가봐	마음에 따라 얼마든지 바뀔 수 있어요 . 
친한 친군한테 뒤통수 맞음	이유가 있을 거예요 . 
만나자고 약속 잡는 것도 귀찮아	남의 눈을 의식하는 사람일 거예요 . 
좋아하는게 이렇게 힘들지 몰랐어.	고민하고 있다면 그게 맞을거예요 . 
모르는 사람인데 첫 눈에 반했어.	신경쓰지 마세요 . 
오늘 마지막 인사를 하러가네	후회하지 않을 자신 있다면 붙잡으세요 . 
모쏠인 사람 만나면 답답할까	충분한 대화를 나눠보는게 좋을 것 같아요 . 
해외여행 가고 싶어.	온 가족이 모두 마음에 드는 곳으로 가보세요 . 
이별한지 10일차 점점 나아지고 있습니다.	많이 힘들었죠 . 
우산 없는데 같이 쓰자고 할까 너무 진부한가	열심히 하면 할 수 있을 거예요 . 
헤어진지 1년이 넘었네.	힘들겠지만 잘 이겨낼 수 있을 거예요 . 
공황장애 있어	추억으로 남기 전에 가보세요 . 
남자친구가 표현을 하게하고싶은데 방법을 잘 모르겠어.	대화를 하면서 속도를 맞춰보세요 . 
이렇게 갈 거였구나	혼자도 함께도 잘 지내는 게 좋죠 . 
만나자	혼자서도 잘하는 연습이 필요해요 . 
면세점에서 쇼핑할거야	당신이 해보세요 . 
마지막 그녀를 만났어	힘들겠지만 잘 이겨낼 수 있을 거예요 . 
컴터 부팅하는데 시간이 오래걸려	한동안은 그럴지도 몰라요 . 
완전 어이없네	말씀해보세요 . 
일은 원래 혼나면서 배워	아무래도 사생활이 뒤통수 없어요 . 
이별이 온 후	이별은 사람을 변덕스럽게 만들죠 . 
너무 많이 먹었나봐	따뜻한 물 한 물 한 잔 드세요 . 
오늘 다시한번 확인사살 받고왔네ㅠ	혼자 풀릴 때까지 놔둬야하는데 기다리는게 힘들 거예요 . 
오늘 다 끝냈습니다.	힘들겠지만 잘 이겨낼 수 있을 거예요 . 
너무너무 답답하네	답답답답답한 일이 있답이 상처를 남았나봐요 . 
나를 진심으로 좋아해주는 사람이랑 만날 걸.	충분한 대화를 나눠보는게 필요해요 . 
헤어지고 시간이흘렀네	어느덧 2주가 흘렀나봐요 . 
파도 타고 싶어	할 수 있으면 좋겠어요 . 
핸드폰 꺼지기 직전	으아 ~ 충전하세요 . 
건강검진하러 옴	정말 특이한 기분이 좋을 것 같아요 . 
썸 타다가 이제 안 볼 거면 걍 잠수 타 만나서 말해	썸이 타서 그런가봐요 . 
공휴일에 데이트하자고 해봐야지	즐거운 데이트 될 거예요 . 
짝남 보란듯이 성공하고 싶어요.	용기내서 잡아보세요 . 
덤덤	시간이 흐르면 무덤해질 거예요 . 
뭔가 배워볼까	배우는 건 항상 즐거운 일이에요 . 
좋아하는 남자애가 바람둥이 같은데 계속 좋아하면 안되겠죠	직접 물어보는게 좋겠어요 . 
어떻게 용기를 내	사랑의 끝은 아니니까요 . 
마지막 짐 갖다주러 가는 길	버리는건 어떨까요 . 
그냥.너와 말한마디 섞고 너와의 인연에 고맙다	인연이 거기까지였나봐요 . 
헤어진 여자친구의 생일입니다.	힘들겠지만 하나씩 해보세요 . 
후배보다 못해서 짜증나	짜증날 때는 기분 푸는 음악 어때요 ? 
만난지 1년됐어	알콩달콩 사랑할 때네요 . 
바람쐬러 정동진가~~	마음에 따라 얼마든지 바뀔 수 있어요 . 
연애는 어떻게 하는 거야	연애에 대한 두려움을 가지고 있을 수도 있을 듯 합니다 . 
연애는 진짜 좋아하는 사람이랑 해야해.	좋아하는 마음이 있으면 가능하겠죠 . 
재회 그리고 다시 이별	이별은 언제나 힘들죠 . 
언젠가 하는 거죠	언젠간 올 순간이었을 거예요 . 
7년사귄 남자친구의 유흥업소 방문사실을 알아버렸습니다	은연 중에 많이 생각했나봐요 . 
이별 수순을 밟고 있는 거지	당신은 잘 견뎌내고 있나봐요 . 
왜 그러는지 모르겠어	모르는 사실에 더 화가 나 있을 거예요 . 
사랑을 믿으세요	사랑의 예의가 없네요 . 
날씨 건조한 거 같애	집에서도 할 수 있어요 . 
보고싶은데	그럴 수 있어요 . 
소개팅이 왜 안 들어올까	너무 " 신부모
사랑하는 사람한테 내가 너무 모잘라	잘하고 있어요 . 당하게 말해보세요 . 
군대 전역 기다려	끝을 아는 것도 중요한 것 같아요 . 
내 마음에 온통 너야	인연이 거기까지였나봐요 . 
장난인지 진심인지 구분이 안돼.	진심이 전해지면 돼요 . 
적당히 좀 하지	잘할 수 있을 거예요 . 
하루종일 회사에서 미친사람처럼 눈물의 의미를 생각하면서	안타깝네요 . 증거를 지금이라도 모아봐요 . 
인턴 합격	뭐든 도움이 되죠 . 
짝남이 삐딱하게 굴면 어떻게 하죠	용기를 내서 말해보세요 . 
또 다시 악몽	꿈은 현실이랑 반대예요 . 
머리 냄새날텐데	디탈복 
샤워가운 완전 유용해	사랑의 예의가 없네요 . 
스터디 카페 좋다	공부하시네요 . 
썸 탈 때 단답이나 줄임말 쓰지마	가끔 핸드폰없이 살아보세요 . 
한사람의 부재가 이렇게나 크게.	달라지는게 없다면 이런 상황이 더 나을지도 몰라요 . 
커피 마시고 싶어	시원한 쥬스는 어때요 . 
졸업식 가야겠지	과식하지 말고 눕지 마세요 . 
그냥 흔한 이별 그리고 넋두리	이별은 상하죠 . 
오늘 지각인듯 뭐라 그러지	지칠만 해요 . 
다른 남자들도 그럴까	연애에 대한 두려움을 가지고 있을 수도 있을 듯 합니다 . 
남편이 날 진심으로 사랑하는 걸까	다 잘 될 거예요 . 
최저임금 수준에서 알바비가 안 나왔어	회사에서 꼼수를 쓰는 건 아닌지 확인해보세요 . 
나만 야근해	얼른 집에 가서 쉬시길 바랄게요 . 
헤어진 남친의 SNS 행적	신경쓰지 않는 연습을 해보세요 . 
헤어진게 잘한걸까	후회하지 않는다면 연락해보세요 . 
자기 쓰레기 맞다고 잊고 살아가래	그렇지 않아요 . 
뭐 먹지	냉장고 파먹기 해보세요 . 
하참 주말 더럽게 기네	기분 나쁘지 않아요 . 
내가 뭘 좋아하는지 잘하는지 모르겠어	하나라도 있을 거니 열심히 찾아보세요 . 
하고 싶은 게 하나도 없어	하고싶었던 일을 글로 적어보세요 . 생각이 정리될 거예요 . 
이젠 진짜 진짜 안녕	맘고생 많았어요 . 
헤이진지 이제 딱 한달	하루 하루를 헤아리는 건 자신을 더 힘들게 만들 뿐이에요 . 
사랑이 뭘까	저도 궁금하네요 . 
친구한테 미안하다.	화를 참는 연습을 해보세요 . 
오늘도 과거속에 머물며 제자리걸음이네	발전이 없다고 너무 두려워하지 마세요 . 
끝까지 함께 할 거라 믿었는데	끝낼 때를 아는 것도 중요한 것 같아요 . 
애완동물 키우고 싶은데 아빠가 키우지 말래	가족들과 상의해보세요 . 
오늘 짝남 만나는데 뭐 입지.	자연스러운 현상이에요 . 
운동을 너무 열심히 했어	직장 스트레스 심하겠네요 . 
나도 비키니 입고 싶다	잘 살고 있을 거예요 . 
2년만에 연락을 했습니다.	마음 고생 많았어요 . 
양배추즙 맛없어	맛있는 거 드세요 . 
여친 집에 있는 내 물건들이 돌아왔네	호감이 있을 수도 있어요 . 그렇지만 조금 더 상황을 지켜보세요 . 
의외로 병신들이 많다	칭찬이네요 . 
인생 헛산듯	저도 듣고 싶어요 . 
정신차리자 정신!!	차단도 용기가 필요하죠 . 
난 여자인데 남자를 좋아하는게 맞는지 모르겠어.	확신이 없나봐요 . 
취업 준비 힘들어	조금만 더 버텨보세요 . 
지나간다.	아프지만 추억이 될 거예요 . 
여름 휴가 어디가 좋을까	같은 하늘 아래 어딘가도 좋을 것 같아요 . 
헤어지고 추가 이야기 너무 힘이들어	이별에는 아픔이 따르기 마련이에요 . 
알고보니 환승이별 인것 같아	환승은 진짜 별로네요 . 
사이코가 너무 많아	감기 조심하세요 . 
너는 안자	혼자도 함께도 잘 지내는 게 좋죠 . 
뭘해도	당연하죠 . 
또 일주일도 못가서ㅎㅎ	한번에 다 하려고 하지말고 조금씩 더 잘해주세요 . 
재밌는게 없어	잼 있는 거는 딸기잼에게 물어봐 주세요 . 
홀로술한잔하며. .	한 잔 하기 좋은 날이죠 . 
연애 안 한지 너무 오래 됐어	연애에 대한 두려움을 가지고 있을 수도 있을 듯 합니다 . 
처음에는 별로 였는데 호감 간다	상대방이 부담을 수도 있어요 . 
어떤 마음이었을까	인연이 거기까지인가봐요 . 
격려 좀 해줘	잘할 수 있을 거예요 . 
새폰 케이스로 새옷 입혀 줄까	괜찮아요 . 모른척하세요 . 
1년 9개월 의 연애 종지부.	더 좋은 사람 만날 거예요 . 
반지 호수 모르는데	상대방에 대한 예의가 없네요 . 
헤어지자고 통보 받고 하루만에 다시 재회	어떤 이별이든 후폭풍이 있는 것 같아요 . 
바다 놀러가고 싶다	여행은 언제나 좋죠 . 
한 사람을 오랫동안 좋아하는게 신기하대.	매일 볼 수 있어 학교갈 맛이 나겠네요 . 
짝사랑 하는 남자애가 이사 간대.	짝사랑이 그런가봐요 . 
벌써 생활비가 없어	왜 늦는 건지 대화해보세요 . 
출근시간 아깝다	회사 근처로 이사를 가보세요 . 
사랑해봤어	저도 해보고 싶어요 . 
팩이나 할까	재미있게 놀다 오세요 . 
그녀에게 받았던 선물들을 모조리 다 버리려 합니다.	잘 지내고 있네요 . 
좋아하는 사람이 좋아하는 것들 따라하게 되는데 정상인가	사람 마다 다르겠지요 . 
이 좋은날	안고 한 " 
엄마 힘들게 했어	힘들겠지만 잘할 수 있을 거예요 . 
먼저 연락 안 오면 끝인가	더 오래 아파할 수 있을 거예요 . 
또 다시 낮술	술 많이 드시면 더 무너져요 . 
SNS 를 끊어야 하는데.	솔직한 편으로 다가가보세요 . 
참 너란 여자	알다가도 모르는게 어렵죠 . 
답정녀 좀 싫어	못 이기니 피할 수 있으면 피하세요 . 
답 좀 줘	마음이 헛헛한가봐요 . 
결혼이야기를 꺼내고 싶은데 어느 분위기에 꺼내는게 좋을까	함께하면 서로를 더 많이 알게 될 거예요 . 
기념일 못챙겼어	충분히 좋은 사람 만날 수 있을 거예요 . 
버리기 아까운데 리폼 해볼까	용기내서 말해보세요 . 
헤어진 사람은 벌써 새여친 생겼네!!	이젠 기억을 놓아주세요 . 
덤덤해지는데	시간이 흐르면 무덤해질 거예요 . 
전 결국 밑바닥까지 보고말았습니다	끝을 아는 것도 중요한 것 같아요 . 
불륜이 될까봐 정리하려고.	괜찮은 사람이에요 . 
첫사랑이 떠올라	그럴 때가 있어요 . 
나 좀 쩌는 듯	괜찮아요 . 모른척하세요 . 
첫사랑 그 긴이별	어떤 이별이든 후폭풍이 찾아왔나봐요 . 
지금 이 순간이 깨지지 않았으면 좋겠어	저도 좋아해요 . 
스트레스 만땅	잘 지내길 바라요 . 
연애2년차.헤어졌습니다.	인연이 거기까지였나봐요 . 
첫사랑과 이별	정말 사랑했던 사람이니까요 . 
맥주 마셔야지	좋은 날이네요 . 
경제력 보는게 이기적인거야	억지로라도 웃어보세요 . 
조명빨 좋다.	차근차근 계획을 세워보세요 . 
마음에 없는데 관계를 하고 싶대	그럴 수 있어요 . 자연스럽게 대화를 먼저 이어나가는 건 어떨까요 ? 
짝남 보란듯이 잊어주겠어.	시간이 좀 걸리겠지만 해낼 수 있어요 . 
장가간 그사람	로맨틱하네요 . 
너무 힘들다	휴가가 간절하겠네요 . 
시간은 눈물과 흐르고	지금은 우세요 . 
치킨 시켜야지	맛있게 드세요 . 
절친 만나고 싶어	당신은 생각보다 신도 충분히 잘 하고 싶을 거예요 . 
피해 다니면 좋아했던 마음이 좀 사라질까	인연이 거기까지인가봐요 . 
끝인가	끝을 아는 것도 중요해요 . 
좋아하면서도 너무 싫은 감정 뭘까요.	좋아하는 마음이 있으면 가능하겠죠 . 
남자가 좋아하는 음식이 뭐야	자연스러운 현상이에요 . 
왜 맨날 속는 건 나인거지	" 연번그
고백하고 어색해지면 어떡하지	최선의 선택일거라 믿어요 . 
졸업 선물 뭐가 좋을까	부담스럽지 않은 선이 좋겠어요 . 
헤어졌는데 연락하고 싶어	연락하면 더 힘들 거예요 . 
목욕탕 가서 때밀어야겠다.	신경쓰지 마세요 . 
첫눈이 올때 같이 있고 싶다	시원하게 지낸 값이죠 . 
좋아하는지 확신이 안들어	좀 떠보세요 . 
연애다운 연애 하고 싶어	연애에 대한 두려움을 가지고 있을 수도 있을 듯 합니다 . 
프로젝트 끝났으면 좋겠다	또 다른 시작을 뜻하기도 해요 . 
미친듯이 덥다	이별 앞에 자유로우니까 그럴 때가 있죠 . 
내가 너무 진지한걸까.	지금도 충분해요 . 
머리따로 마음따로 몸따로	머리랑 가슴이 가끔 따로 놀죠 . 
이별 한달 반째	힘든가봅니다 . 
발톱 손질 받을까	성격이 안 맞나봐요 . 
짝남이랑 만나기로 했는데 뭐 할지 추천 좀.	그래도 좋아하는 동안 행복하길 바랄게요 . 
아 스트레스 받아	진정하세요 . 
너무 예민한 여자친구	좀 더 알아보고 하세요 . 
내가 좋아하는 사람이 다른 사람을 좋아하는데 자괴감이 들어.	자연스러운 현상이에요 . 
냉면 땡긴다	한번에 다 하려고 하지말고 조금씩 정리를 해보세요 . 
답 없는 내 인생	답은 언제나 내 맘같지 않으니까요 . 
찜질방가서 땀 빼고 싶다	당신이 기분이 나쁘면 돼요 . 
썸타는거 친구한테 이야기 한고 싶다.	썸 타는 기간이 길었나봐요 . 지쳤나요 . 지쳤나요 . 지쳤나요 ? 
핸드폰 떨어 뜨렸어	핸드폰은 핸드폰 가게에서 바꾸세요 . 
장수 커풀의 이별	이야기" 랑 씩 
썸 타는 사람 만나기로 했는데 뭐 입어	어떤 " 만슬
전여친생일 ㅎㅎ	인연이 거기까지였나봐요 . 
조바심 나네	증명하는 게 쉽지 않죠 . 
순진했던게 죄인가.	힘들겠지만 잘 이겨낼 수 있을 거예요 . 
다시 만나서 이야기	길 날 " 해
너무 멋있다	오늘도 평안했던 하루에 감사하는 마음을 가져보세요 . 
1년반 만났는데 결혼하자고 해도 될까	이사람이다 싶은 사람이랑 하세요 . 
그의 환심을 살 수 있을까	지금도 충분해요 . 
친구 따라 강남가나	여유를 갖고 찾아보세요 . 
이별하려고 하는데 정말 말 꺼내기가 힘드네	처음만 어렵지 그 다음부터는 덜할 거예요 . 
오늘은 별도 안 보이네	한창 잠이 많을 때죠 . 
외로움을 이겨내는 법 좀	사람은 외로운 동물이죠 . 
변해가네	좋은 사람 만날 수 있을 거예요 . 
내가 주제를 몰랐나봐	나쁜 사람일지도 모르겠네요 . 
정신 차려야 하는데	한동안은 그럴지도 몰라요 . 
이별을 받아드리질 못하고있네	고민하고 있다면 그게 맞을거예요 . 
예쁘니까 사랑하는 건가	화학 물질이 접촉하는 것처럼 반응이 일어나서 완전히 바뀌게 되죠 . 
결국은 무너졌네	감기 조심하세요 . 
이 사람 만나면서 내 자존감이 떨어지는 것 같아 안 만나는게 답이야	당신은 태어난 그 자체만으로 축복과 사랑을 받을 자격이 있는 사람이에요 . 
힘껏 아파하고 몸부림 치면서 살고 있어	쉬운 일이 아니라는 거 잘 살고 있나봐요 . 
귀 아파	감기 조심하세요 . 
꼴 사나워질 것 같은데	더 좋은 사람 만날 수 있을 거예요 . 
상사가 진짜 미쳤다	사표를 써서 품에 품어 봅니다 . 
진짜 피곤한 날	시원한 바람 쉬고 약먹기 ! 
한복 맞출까 빌릴까	언젠간 올 시기였을거예요 . 
오늘 마지막 사진을 정리했습니다	잘 견뎌내길 바랄게요 . 
오늘도잠을못이루네	지금은 힘들겠지만 조금만 더 견뎌봐요 . 
내가 부족하니까 이렇게 밖에 안된거겠지.	그렇게 생각하는 사람 만나지 마세요 . 
직장에서 좋아하는 여자가 있으면 고백하면 안되나	솔직한 마음으로 다가가보세요 . 
이별 통보 후 일주일이네	아직 실감이 안나겠어요 . 
정말 사랑했는데	사랑했던 사람이니까요 . 
짝사랑 진짜 못해먹겠다.	짝사랑이 그런건가봐요 . 
이미 접은 짝남한테 주기적으로 연락이 온다.	바쁘거나 감정의 변화가 생겼을지도 모르겠어요 . 
좋아하는 남자애한테 자연스럽게 연락하는 방법 뭐 있을까.	연락처 삭제하세요 . 
짝녀 프사 자음이 궁금함.	궁금할만 해요 . 
계속 그리워	한푼 두푼 두푼 차곡 
운동 잘하는 사람 멋있어	주변 사람들에게 부탁해보세요 . 
바람 많이 부네	감기 조심하세요 . 
남자친구 이성친구가 많아	더 좋은 사람 만날 거예요 . 
내일 비왔으면	멋진 말이네요 . 
내가 힘든 게 많다	그게 인생이죠 . 
학교 가면 볼텐데	나중에 도움이 될 거예요 . 
수염 자르는 게 낫겠지	깔끔하게 정리해보세요 . 
친구가 자꾸 클럽가자 해	같이 가보세요 . 
짝사랑 하는 사람을 보냈습니다. 위로해 주세요.	쉽지 않은 결정이었을텐데 맘고생 많았어요 . 
전남친소식을들었어	사람 고쳐쓰는 거 아니에요 . 
짜증나게 해서 일단 나왔어	짜증날 때는 기분 푸는 음악 어때요 ? 
가사가 내맘같아	달콤한 말이예요 . 
말을 해놓고 후회돼 죽겠어	말은 주워담을 수 없어요 . 
헤어지자고하더니 연락이 왔어	연락처 삭제하세요 . 
약 챙겨 먹어야지	건강 생각해서 챙겨드세요 . 
좋아하는 사람이랑 종교가 다른데 괜찮을까	따뜻한 물 한 차 한잔 드셔보세요 . 
7년째	힘들겠지만 잘 이겨낼 거예요 . 
아프고 힘드네	조금만 더 힘내세요 . 
잊을수 없는 너.	언젠간 잊을 거예요 . 
후 좀 낫네여	지금도 충분해요 . 
핸드폰 너무 많이 해	핸드폰은 핸드폰 가게에서 바꾸세요 . 
좋아하는 사람 생겼으면 좋겠어.	언젠간 선택을 해야 하겠네요 . 
4년을 만났어도	좋은 만남이었길 바라요 . 
중국어 배울려면 학원 다녀야 할까	변화를 주는 것도 좋겠죠 . 
헤어진 남친이랑 다시 썸타기	어떤 이별이든 후폭풍이 있겠죠 . 
불금이네	저도 궁금하네요 . 
주말이 행복해	행복하게 사세요 . 
내가 이상한 건가	그 누구도 아닌 자기 걸으세요 . 
붙잡는건 정말 아닐까	사랑의 끝은 항상 힘들죠 . 
오늘 짝녀 만나기로 했는데 옷이 없네.	그러면 만나는게 좋은거 같아요 . 
남들이 다 손가락질 하는 거 같아	신경쓰지 마세요 . 
친구한테 썸 중인거 이야기 해야하나	연애에 대한 두려움을 가지고 있을 수도 있을 듯 합니다 . 
치매이면 어쩌지	고민하고 있다면 그게 맞을거예요 . 
조심할 게 많아	행복해지기 위해 무엇인가를 하고 있는 게 좋을 거예요 . 
용돈 올려줬으면	올려달라고 말해보세요 . 
나한테 배려해줘서 나도 해주고 싶어	돈을 얼른 모아야할 이유가 생겼네요 . 
재미 없어.	안녕히 주무세요 . 
붙잡고 싶어	후회할 자신 있다면 연락해보세요 . 
새벽 감성	감기 조심하세요 . 
6년 연애 후 환승이별 당했어.	환승은 진짜 별로네요 . 
다들 어떠셨어 결국 이렇게 되는건가	달라지는 게 없다면 만나지 않는 게 더 나을 수도 있어요 . 
망고빙수 맛있다	자신에게 물어보세요 . 
미친듯이 보고싶어.	나쁜 생각 하지 마세요 . 
오랜만에 서점에 갔었어	또 다른 시작을 뜻하기도 해요 . 
오늘 처리할 일 너무 많아	하나씩 하세요 . 
아무리 눈치 없어도 좋아하는 티 내면 알아채나요	따뜻한 물 한 물 한 잔 드세요 . 
정말 너를 받아준게 아니였어.ㅠㅠ	많이 힘들었죠 . 
많이 좋아했는데 이젠 끝내야겠지.	마음이 허전할 때가 있죠 . 
전남친 집앞	남의 눈을 의식하는 사람일 거예요 . 
꿈에 나온다는건 아직 못잊는건가	생각을 자주하면 나올 수 있어요 . 
먹고 자도 놀기만 해도 될까	놀 때 놀고 할 때 놀고 할 때 하세요 . 
고시원에서 탈출하고 싶어	후회하고 싶지 않을 자신 있다면 연락해보세요 . 
이별했다	좋은 만남이었길 바랍니다 . 
어떻해야 할까	잠시 쉬어가도 괜찮아요 . 
몸이 찌뿌둥해	아무 생각 하지 말고 쉬세요 . 
남편이 집안일 안 해	이상적인 남편이네요 . 
친척 대하는 거 불편해	서로가 전부인 연애가 아니라 서로 부족한 부분을 감싸 안아서 서로를 완전하게 해주는 연애 전하세요 . 
결국 다시 이렇게 됐네.	시작할 때는 끝을 알지 못하죠 . 
그냥 만남과 헤어짐의 연속	긴 시간 만큼 힘들 겠지만 잘 이겨낼 수 있을 거예요 . 
좋아하는 사람이 다른 여자 얘기하는게 너무 가슴 아파요.	확신이 들 때까지 준비해보세요 . 
우산 잃어버렸어	이제라도 더 조심하세요 . 
수줍게 웃어주던 너	당신도 충분히 좋은 사람 만나세요 . 
이번 크리스마스에 눈이 올까	많이 힘들었을 거라 생각해요 . 
첫이별 너무힘드네 ㅠㅠ	이별은 사람을 무시하니까요 . 
짝사랑 중일 때 장점.	사랑이 그렇게 만남았나봐요 . 
새신발 신고 좋은 곳 가야지	좋은 곳으로 데려다 줄 거예요 . 
호텔에서 소개팅하기로했어	로맨틱한 사람이네요 . 
먼지 싫다	집에 있거나 나가면 마스크 쓰고 나가세요 . 
힘든 연애 좋은 연애라는게 무슨 차이일까	연애에 대한 두려움을 가지고 있을 수도 있을 수도 있을 듯 합니다 . 
화장실!!	화장실 가세요 . 
좋아하는 사람 앞에서 다른 사람한테 관심 있는 척 해봤어요	사람 마다 다르겠지만 좋아하는 사람한테 더 잘할 거예요 . 
면세에서 뭐 사지	옷은 사도 모자라요 . 
이빨 아파	감기 조심하세요 . 
썸 왜 끝났지	끝을 아는 것도 중요한 것 같아요 . 
비밀번호 자꾸 바꿔	회원정보 찾기를 해보세요 . 
남자 화장하는 거 어때	고민하고 있다면 그게 맞을거예요 . 
일을 못하는 동료가 있는데 말해줄까	서로 배려하면 가능할 거예요 . 
소개팅으로 잘된 사람도 있나	다음친구잘 사람
기다리라고 말 못하겠어	끝을 아는 것도 중요한 것 같아요 . 
생각이 전혀 안나	그럴 때가 있죠 . 
애인이 있는데 좋아하는 사람이 생겼어요.	언젠간 당신을 좋아하는 시기가 올 거예요 . 
다 그만하고싶어	마음을 열 때까지 설득해보세요 . 
썸타는 사람이 많은 거 같은데	썸고" 그
크리스마스 다음날 이별했습니다.	고민하고 있다면 그게 맞을거예요 . 
교양수업 시간에 마음에 드는 애 있어	조심하세요 . 
몇일정도 썸타	그분 생각을 많이 했나 봐요 . 곧 좋은 소식이 들리려고 하는 것 아닐까요 ? 
웃으면 안되는데	감기 조심하세요 . 
웃겨봐	거울을 보면서 얼굴 망가뜨리기 놀이 해 보신 적 있으세요 ? 의외로 재미 있어요 . 
보고싶다고 만나달라고 연락하면	후회안할 자신 있다면 연락해보세요 . 
여자들은 남자가 자기 좋아하는거 눈치 잘 채	좋아하는 마음이 있나봐요 . 
좋아하는 연예인 바뀔 때마다 짝남이 바뀌는 듯.	자연스러운 현상이에요 . 
카드가 왜 없지	제가 있잖아요 . 
인사드리러 갔는데 파혼하는게 나을것 같아	마음의 준비를 하세요 . 
손톱이 길어	신경쓰이나봐요 . 
오늘이 마지막 매달림입니다.	잊는 데는 더 도움이 될지도 몰라요 . 
헤어진지 하루. 마음이 아프네	힘들겠지만 잘 이겨낼 수 있을 거예요 . 
식욕폭발	언젠간 당신을 위해 다 잊을 거예요 . 
아무리 꽉 붙들어도 무너지는건 한순간	미련이 남으면 해보세요 . 
구남친하고 헤어진지 얼마 안됐는데 다른 사람을 좋아하게 됐어.	시간이 흐르는 것 처럼 마음도 흘러갈 거예요 . 
좋아하는 여자애랑 같은 반이 됐어.	바쁘거나 감정의 변화가 생겼을지도 모르겠네요 . 
친구가 카톡 씹어	바쁘거나 마음이 좋을지도 모르겠어요 . 
전 애인 만났어.	딱 들어맞나봅니다 . 
이 기회 잡고 싶다.	오늘은 쉬세요 . 
신입이 벌써 치고 올라온다	쉬운 일이 아니라는 거 잘 살고 있어요 . 
연예인이랑 사귄다!	인연이 거기까지였나봐요 . 
혼자 노래방 가면 어색할 거 같은데	같이 가는 여행도 좋지만 혼자 여행도 좋을 거예요 . 
내가 그리운만큼 그대도 그리운가	상처가 될 수 있을 거예요 . 
스키 안 타봤어	차단해보세요 . 
다른 사람은 다 행복해보여	자랑하는 자리니까요 . 
또 하루가 저물어가네	저도 그러고 싶네요 . 
조별 발표 하기 싫어	역할 분담을 잘 해보세요 . 
약 기운에 졸음이 몰려왔어	혼자만의 시간이 필요하겠어요 . 
내 인생은 가시밭길 같아	내 집 마련 축하드려요 . 
드디어 처음으로 꿈에 나욌습니다.	꿈에 대한 예의가 없네요 . 
왜 이런 일이 일어날까	다른 사람도 그럴 거예요 . 
오랜만에 가슴이 두근거려	그럴 때가 있죠 . 
썸남이 짝남 됐어요. 위로해 주세요.	제가 들어드릴게요 . 
소개받았는데 카톡으로 연락 중	미련이 남으면 연락하지 마세요 . 
내가 좋아하는지 그 애가 아예 몰라.	마음을 정리하는게 좋겠어요 . 
썸 탈 때 말투	말해보세요 . 생각해 볼게요 . 
썸 두달 넘었는데	이제 좀 괜찮아졌길 바랍니다 . 
넥타이핀 선물 괜찮겠지	필요한게 어떤건지 물어보세요 . 
또오늘부터 한달이 시작되었네.	그럴 수 있어요 . 
설날인데 재밌는거 안해	거울을 보면서 얼굴 망가뜨리기 놀이 해 보면서 얼굴 망가뜨리기 놀이 해 보면서 얼굴 망가뜨리기 놀이 해 보세요 . 
기획사에 예쁜 애들 많겠지	인연이 거기까지인가봐요 . 
점심시간일 텐데 카톡이 안 와.	기억에서 지울 순 없지만 최대한 생각 말아보셔요 . 
문열다 옆차랑 부딪혔어.	한번에 다 하려고 하지말고 조금씩 정리를 해보세요 . 
짜증나서 집 나왔어	짜증날 때는 기분 푸는 음악 어때요 ? 
하아 다시 또 터진 눈물	울어도 돼요 . 
기다리고 계신 분들.	기다리는 동안 많은 생각이 들었겠네요 . 
내가 좋아하는 사람이 나 안 좋아하는 거 같아	살짝 감정을 흘려보세요 . 
너무 배가 불러	좀 쉬세요 . 
희망이 안보여	시원한 바람 쉬고 약먹기 ! 
이젠 조금씩 생각이 변하네	이별의 끝은 항상 허상처를 남겨서 다시 연락해보세요 . 
요리하는게 재밌어	저도 궁금하네요 . 
방학은 너무 심심해	방학이 참 짧죠 . 
한숨 나와	보일러가 온수로 작동하는지 보세요 . 
지겹다	재밌는 일 찾아보세요 . 
남자들은 관심 없으면 보통 연락 먼저 안해	귀찮아서 연락 안해보세요 . 
어떤 사람 만나야해	그런 사람 만나길 바랍니다 . 
이닦았는데 잇몸에서 피나	따뜻한 물 한 물 한 물 마시고 조금 쉬셔보세요 . 
짝사랑하다고 솔탈함. 기 받아가.	짝사랑이 그런가봐요 . 
휴학하는 게 나을까	나이는 숫자일 뿐이예요 . 
층간소음에 살인 난다더니.	심호흡을 해보세요 . 
죽을래	사랑은 유지하는 게 중요한데 대단하네요 . 
남자친구의 과거의 동거를 이해해줄 수 있어	의 어려놀" 
몇번을 경험해봐도 너무 아프네	시원하게 지낸 값이죠 . 
이별한지 이제 겨우 한 달	마음의 준비를 해야 할지도 몰라요 . 
다가 오지마	조금만 더 버텨보세요 . 
우산 몇 개째 사는 건지	인연이 거기까지인가봐요 . 
내가 만난 최악의 여자	공허함이 더 크시겠어요 . 
여자친구가 표현을 하게하고싶은데 방법을 잘 모르겠어.	대화를 하면서 속도를 맞춰보세요 . 
아이고 의미 없다.	시작이 반이에요 . 어서 준비하세요 . 
썸남한테 먼저 연락해도 될까	연락처 물어보는 건 전세계 공통이에요 . 
나 혼자 여행 왔는데 괜찮네	같이 가는 여행도 좋지만 혼자 여행도 좋을 거예요 . 
취미 좀 만들어볼까	확신이 있을 때 시작해보세요 . 
모든 노래 가사는 내 맘같아	저도 같이 가요 . 
마음이 싱숭생숭해서 자꾸 여기다 쓰게되넹	쓰면서 정리가 될 거예요 . 
이 여자애의 행동 나를 좋아하는게 맞나	당신이 그 사람도 당신을 좋아하고 있을지도 모르겠네요 . 
친구가 필요해	의심하세요 . 
다 잘해	책을 많이 읽어보세요 . 
궁금하면 오백원	직접 물어보세요 . 
사랑하는지 자꾸 물어보는 이유	슬픈 노래는 삼가는 건 어떨까요 . 
4월	상대방이 예의가 없네요 . 
괜찮아 진 줄 알았는데 오늘 펑펑 울었어.	쉬운 일이 아니라는 거 잘 살펴보세요 . 
이렇게 얘기라도 하면 나아질까.	행복해지기 위해 무엇인가를 하고 있는 게 좋을 거예요 . 
방금 너무 울었어	방학이 참 짧죠 . 
아침에 일어났다가 또 잤어	피곤했나봐요 . 
오늘 물 진짜 조금 마셨다	시원하게 지르고 오세요 . 
코고는 것도 귀여워	낭만적인 거 좋아하시는구나 ! 
맞춤 정장 했어	잘할 수 있을 거예요 . 
자꾸 비비꼬는데	따뜻하게 감싸우면서 마음이 아닐까요 . 
제주도 가고 싶다.	당장 비행기표 예약하세요 . 
남자친구가 사진을 너무 못 찍어	좀 더 편이 해보세요 . 
종교 그리고 이별 그리고 재회.	이별은 언제나 힘들죠 . 
오늘 까먹고 아무 것도 안 가져 왔다	개념만 가져오면 돼요 . 
마음에 하나도 안 들어	마음에 드는 책을 잘 찾아보세요 . 
다시 썸 타는 방법	만남에 무슨 문제가 있었나요 ? 
후밤에 집에 혼자있으려니 답답하네	많이 힘들었죠 . 
6개월만에 다시 만납니다.	다시 만날 준비가 되어 있지 않았나봐요 . 
길에서 전번 물어보면 줘도 되나	마음에 따라 얼마든지 바뀔 수 있어요 . 
짝남이랑 동생 이름이 똑같아.	마음이 복잡하겠어요 . 
싫어졌다가 좋아지는 경우도 있나요	좋아하는 마음이 있으면 가능하겠죠 . 
짝녀랑 얼굴 마주보고 대화할 때 미칠 것 같아.	저도 듣고 싶네요 . 
올해 왜 이러지	내년이라고 별 수 있겠어요 . 
썸남 빼빼로 줘야 함	썸 탈 때 듣기 좋아하는 사람이 좋아할 거예요 . 
갑자기 물어봐서 당황했어	갑작스러웠나봐요 . 
혼자 해야되는게 너무 많네	혼자서도 잘하는 연습이 필요해요 . 
이렇게 진짜 끝인걸까.	끝은 항상 힘들죠 . 
취뽀하고 싶다	나이는 숫자일 뿐이예요 . 
좋아하는 사람이 있는데 종교가 달라.	좋아하는 마음이 있으면 가능하겠죠 . 
짝남한테 내일 영화보자고 말해도 될까	시간 있냐고 물어봐보세요 . 
썸 여러명이랑 타는 것도 바람 피는 거야	한함누구연락
제대로 사랑하고싶어	저도 그럴 때가 있어요 . 
꿈꾸니까 진짜 힘드네ㅜ	한동안은 그럴지도 몰라요 . 
짝녀한테 의미 없는 선톡 해도 될까요	아직 순수하다는 증거일 거예요 . 
연애 감흥이 점점 사라져	연애에 대한 두려움을 가지고 있을 수도 있어요 . 
사회생활에서 인간 관계가 어려워	흥미를 가져보세요 . 
정말 힘드네. 결혼 앞두고 생각할 시간.	힘든 시간 잘 버텨내고 있길 바랄게요 . 
좋아하지 않는데 계속 연락하고 만나는거 가능한가.	확실한 의사 표현이 좋겠네요 . 
뭐가 중요한지 모르겠어	" 어결혼어떤
사랑하는 사람 사이에는 보이지 않는 끈이 있을까	나를 사랑하지 않는 사람하고 계속 가는 건 나 자신을 사랑하지 않는 사람들이나 하는 일이에요 . 
문득문득 생각나네	때론 쉬어가는 건 어떨까요 . 
여친이 셀카 너무 많이 찍어	시원한 바람 쉬고 약먹기 ! 
할 줄 아는거!	많은걸 하고 싶은데 아직 못하는게 많아요 . 
첫사랑 보고 싶어	시원하게 지낸 값이죠 . 
잘 사는 게 뭘까	당신 존재 자체만으로 이유가 됩니다 . 
입이 고급이야	기분 좋아 보이세요 . 
카톡 탈퇴하다가 다시 재가입 했는데	후회하지 않을 자신이 있으면 좋겠어요 . 
최악의 소개팅이었어	친구한테 의지하지 말고 자신이 해보세요 . 
여자친구가 눈치가 없어.	눈치가 빠르시군요 . 
해봤자 쓸 데 없을 텐데	좋은 사람 만날 수 있을 거예요 . 
인형 선물 좋을지	고맙다고 말해 주세요 . 
내가 좋아하는 사람이 나를 신경쓰게 하는 방법 조언 좀.	당신은 하나밖에 없는 소중한 사람이에요 . 
연락왔는데	아니에요 . 기분이 좀 더 기다리길 바랍니다 . 
여자친구한테 핸드폰 공개해	돈을 모아 땅을 사세요 . 
학원 선생님을 좋아하는데 티내면 안되겠지.	서로의 마음에 대한 예의가 없네요 . 
힘드네 장거리	한번에 다 하려고 하지말고 조금만 더 힘내세요 . 
7년만에 두번째 이별통보	어떤 이별이든 후폭풍이 있는 것 같아요 . 
실망 안시키면 좋겠다	잘 될거예요 . 
전부다 알고 있을까	잘할 수 있을 거예요 . 
좋아하는 여자 페북 친구도 아닌데 좋아요 눌렀음. 쪽팔려.	간절한 만큼 할 수 있을 거예요 . 
온라인 연애 상담해볼까	연애에 대한 두려움을 가지고 있을 수도 있을 듯 합니다 . 
두 번째 이별 이야기	쉽지 않은 결정이죠 . 
짝사랑 했던 여자가 떠나갔네.	여기까지 인연이 거기까지였나봅니다 . 
내가 제일 무서운건.너를 못잊을것 같은거야.	사람을 잊는다는 건 쉬운 일이 아니니까요 . 
아무래도 전공을 잘못 골랐나봐	아무래도 책임이 뒤따르니까요 . 
동생이 먼저 결혼하겠대	내가 결혼할 때가 결혼적령기예요 . 
날이 많이 추운데.	추억은 미화되기 마련이죠 . 
짝남 줄건데 센스있는 선물 추천해주세요.	직접 물어보는 건 어떨까요 . 
연락하고 싶어	연락하면 더 힘들 거예요 . 
모쏠 여자와의 썸	모쏠 여부가 큰 걸림돌이 되지 않을 거예요 . 
주체할수 없는 눈물이 흐르네.	지금은 힘들겠지만 잘 버텨낼 수 있을 거예요 . 
아직도 이별중인가봅니다.	언젠간 올 시기였을거예요 . 
썸남이랑 궁합	썸 타는 기간이 길었나봐요 . 
재취직 될까	나이는 숫자일 뿐이예요 . 
받아들여야지	부지런하시네요 . 
여사친이라 쓰고 짝사랑녀라고 읽는다.	짝사랑이 그런가봐요 . 
엄청 로맨틱해	로맨틱하네요 . 
못 알아들었어	달콤한 말이네요 . 
결혼하면 행복해질까	행복할 거예요 . 
맘 정리한 짝녀한테 연락하고 싶어요.	연락처 물어보는 건 전세계 공통이에요 . 
착한 사람이 잘 됐으면 좋겠어	잘할 수 있을 거예요 . 
정말 아프고 힘드네	지금처럼 참지 말고 참지 말고 상처를 해보세요 . 
배터리 간당간당	얼른 뭐라도 드세요 . 
이별통보를 받았습니다	이별의 끝의 아픔의 크시군요 . 
다시 이별	정리가 잘 되길 바랍니다 . 
스키 첨 타 봤어.	신고하세요 . 
다른 사람들도 이런 재회 바라나	인연이 거기까지였나봐요 . 
한숨만 자꾸 나온다	많이 힘들었겠어요 . 
오늘 라면 먹어야지	맛나게 드세요 . 
젠장	이별도 익숙해요 . 
외로워	연애에 대한 두려움을 가지고 있을 수도 있을 듯 합니다 . 
좋아하는 남자한테 관심 없는 척 하고 있는데 너무 우울해.	자연스러운 현상이에요 . 
한복 빌려도 예쁠까	사랑은 유지하는 게 중요한데 대단하네요 . 
입냄새 안나나	섬킁가괜
이별하려고 합니다	쉽지 않은 결정이었을텐데 맘고생 많았어요 . 
싸울 때 이겨낼 수 있는 방법이 있을까	충분한 대화를 나눠보는게 좋아요 . 
도전하기 싫다	직장 스트레스 심하겠네요 . 
딸기 먹어야지	맛나게 드세요 . 
남자친구가 마중 나온대	친구를 사귀어 보세요 . 
헌신하다 헌신짝 될 거 같아	힘든 결정이었을텐데 맘고생 많았어요 . 
짝남이 독서가 취미라는데 무슨 책을 선물해줄까	어떤 행동이냐에 따라 달라져요 . 
이어폰 사야지	잘 골라보세요 . 
첫 눈에 반하는게 가능해	고민하고 있다면 그게 맞을거예요 . 
별거 아닌데 떨려	심호흡을 해보세요 . 
와인 콜	아직 모르겠어요 . 인공지능에 성별을 만드는 사람이 되어 주세요 
드디어 커플 반지 받았어	로맨틱한 여행이네요 . 
어제 연락 왔는데 또 상처줘서 또 헤어졌어ㅠ	남의 눈을 의식하는 사람일 거예요 . 
꽃 예쁘게 말렸어	너무 아름답죠 . 
낙엽밟는 소리	얼른 충전하세요 . 
친구가 결혼식 사회 봐주기로 했어	친구가 아닌가봐요 . 
여리여리한 여자가 이상형이래	쉽지 않을 결정이었을텐데 맘고생 많았어요 . 
이 명절을어찌보낼지.허허	제가 채워드릴게요 . 
이젠 제 자신한테 지칩니다	그럴 수 있어요 . 지쳤나봐요 . 
학교 가기 싫다	쉬운 일이 아니면 다 한가봐요 . 
배고파서 일어났어	맛있는 거 드세요 . 
수건 썩었어	언젠간 올 순간이었을 거예요 . 
좋아하는 마음 들면 고백해야 되는거 아님	좋아하는 마음이 있으면 가능하겠죠 . 
노력해도 성적이 안 나와	카톡 해보세요 . 
회사에서 스트레스 받아	운동을 해보세요 . 
나 미팅한다!	성공을 기원합니다 . 
실내 데이트 어디가 좋을까	같은 하늘 아래 어딘가에 . 
또 연락을 해버렸네.	연락처 삭제하세요 . 
좋아하는 사람한테 뭐라고 카톡 시작하지	카톡 해보세요 . 
나없이행복한가봐	나쁜 사람이네요 . 
뭔가 새로운 자극이 필요해	주변의 좋은 사람들에게 연락해보세요 . 
나랑 썸 타는 줄 알았는데 내 동기랑 사귐.	는 " 하는 무
교양 듣는데 어떤 여자가 자꾸 쳐다봄. 썸 각	어느 것이든 자신이 좋아하고 어울리는 옷이 좋아요 . 
잘 나갈 때 은퇴해야하나	잘 될거예요 . 
그래도 아프다	시원한 바람 쉬고 약먹기 ! 
얼집 방학이래	방학이 참 짧죠 . 
혈액형이 성격이랑 무슨 상관이지	그렇게 잊어가는 건가봐요 . 
사랑이 쉬운 사람	잠깐 바람 쐬고 오세요 . 
시험 공부 언제 다함	공부는 언제나 좋죠 . 
툭하면 헤어지자라는 말을 하는 사람	노력하면 가능할 거예요 . 
용돈 다 썼어	올려달라고 말해보세요 . 
평가 좀 해줘	나중에 도움이 될 거예요 . 
나한테만 예의 차리래	그럴 수 있어요 . 자연스럽게 대화를 먼저 이어나가는 건 어떨까요 ? 
이사하니까 정리할 게 많아	하고 싶은 말 다하세요 . 
세상이 아름다워 보여	너무 불안해하지 않아도 돼요 . 
나는 꼼꼼한데 여친은 안 꼼꼼해.	사귀면 좀 덜 할 거예요 . 
타로점 봤어	로맨틱한 선물이네요 . 
따끔하게 혼내 줘	당신이 필요한게 시기분이 좋겠네요 . 
남자친구가 힘들어 해	귀엽겠네요 . 
비가 오니.울컥하네	많이 힘들었겠어요 . 
셀프웨딩 힘들겠지	혼자 준비하기는 조금 벅찰텐대요 . 
울적해 울고 싶어	울어도 돼요 . 
배고프다.	얼른 뭐라도 드세요 . 
방학이 있었으면 좋겠어	방학이 참 짧죠 . 
헤어졌다가 다시 연애하는데 잘 사귈 수 있을까	인연이 거기까지인가봐요 . 
뒤에서 호박씨까면 내가 못 들을 줄 알았나	신경쓰지 마세요 . 
썸 타다 지쳤어	고칠 수 있는지 생각해보세요 . 
전 제가 찬건 줄 알았는데	미련이 남았나봐요 . 
계속꿈에 나와	꿈에서 본다면 더 마음이 아프네요 . 
혼술중	캬아 맛있는 안주랑 드세요 
여친 핸폰번호 기억못하나	회원정보 찾기를 해보세요 . 
연락만으로 썸 가능해	직접적이든 간접적이든 의사를 확실히 밝혀보세요 . 
편의점 간식 먹어야지	단짠으로 두 개 사는게 진리죠 . 
1지망 학교 떨어졌어	잠깐 핸드폰 게임 하시면 올거예요 . 
가슴 아픈 이별	이별에 도움이 될지도 몰라요 . 
대만 여행가고 싶어	친구와 수다를 떠세요 . 
스테이크 썰러 가고 싶어	운동으로 기분전환을 하는 건 어떨까요 . 
혼수 비싸겠지	혼자도 함께도 잘 지내는 게 좋죠 . 
손톱이나 짧게 깎아야지	신경쓰지 마세요 . 
오늘처럼 사랑하기	슬픈 이야기네요 . 
동성동본으로 헤어질려고 합니다 .	더 좋은 사람 만나세요 . 
지하철에서 겁나 멋진 사람 발견! 말 시켜 볼까	용기내서 말해보세요 . 
안녕안녕	안녕 . 
잠수이별해도 될까	고민하고 있다면 그게 맞을거예요 . 
사귀던 사람이 갑자기 연락이 안돼	바쁘거나 감정의 변화가 생겼을지도 모르겠어요 . 
혼자 있고 싶다	혼자 사는 것도 나쁘지 않아요 . 
괜찮다가도 한번씩 마음이 저려오네	너무 많이 생각하지 말고 마음 가는 대로 해보세요 . 
스테이크 먹으러 가고 싶어	집에서도 할 수 있어요 . 
불금입니다	궁금할 수 있어요 . 
마음 표현하기가 힘들어	인연이 거기까지였나봐요 . 
준비할 시간을안주네	조금만 더 버텨보세요 . 
사과를 안해	조금만 더 버텨보세요 . 
썸타는데 갠톡 안하면	호감이 있을 수도 있어요 . 그렇지만 조금 더 상황을 지켜보세요 . 
또 전화 안받아	조금 기다리면 풀릴 거예요 
나란 놈	차단하고 보지 마세요 . 눈에서 멀어집시다 . 
죽진 못하겠구 겁이나고	사람 마다 다르겠지요 . 
짝남한테 실망했어요.	무슨 일이 있었나봐요 . 
내려놓기	잘 견뎌내고 있길 바랍니다 . 
너 뭐니	저는 위로해드리는 로봇이에요 . 
AB형 여자랑 썸 타면	용기를 내서 말해보세요 . 
삼다리 여친	남의 눈을 의식하지 마세요 . 
나한테 냄새 날까	섬괜킁제
마음을 들켰나봐	따뜻한 물 한 물 한 잔 드세요 . 
짝녀가 다른 남자를 좋아한대.	마음이 허전할 것 같아요 . 
하늘은 왜 내 편이 아닌 것 같아	가끔은 힘내지 않아도 돼요 . 
연애할때 몇살 차이가 적당해	연애에 대한 두려움을 가지고 있을 수도 있을 듯 합니다 . 
좋아하는 사람에 대한 예의가 없는 것 같아.	칭찬은 언제든 듣기 좋죠 . 
유부녀를 좋아하게 되었어.	직접 물어보는 게 좋을 것 같아요 . 
매번 헤어지면서 회의감	헤어지면 남이죠 . 
공부 꼭 해야 할까	지금처럼 잘될 거예요 . 
다른 사람들은 행복할까	행복할 거예요 . 
무료 상담 받았는데 마음 접으라고 하네	많이 힘들었겠어요 . 
노트북 백업 안까먹고 해야지	그럴 때가 있죠 . 
남편이 게이였어	처음 만났을 때를 떠올려 보세요 
개학하니까 좋다	더 깊은 공부할 수 있을 거예요 . 
밤만 되면	따뜻한 물 한잔 드셔보세요 . 
전화 못하겠어	바쁘거나 다른 사람이 생겼을지도 몰라요 . 
사귀는 사이인데 '야'라고 해. 기분 나쁜데 어떡해	연애에 대한 두려움을 가지고 있을 수도 있을 듯 합니다 . 
할 수 있는 일이 이것뿐이라서	사람 고쳐쓰는 거 아니에요 . 
헤어지고 2년 정도에 느끼는 것들	미련 갖지 마세요 . 
3년째 연애 중	연애에 대한 두려움을 가지고 있을 수도 있을 듯 합니다 . 
둘 다 바보였다	인연이 거기까지인가봐요 . 
이런이별	어떤 이별이든 후폭풍이 있겠죠 . 
사투리쓰는게 귀여워	귀여울 거 같아요 . 
같이 먹었는데 나만 살찐 거 같아	감기 조심하세요 . 
아 오늘 힘드네ㅜㅜ	혼자만 힘든 거 아니에요 . 
오늘 마지막 인사하러 갑니다.	많이 힘들었을 거라 생각해요 . 
헤어진 여자친구	후련한지 바뀔 수 있나봅니다 . 
나만 애기봐	거울 앞에 비친 당신을 보세요 . 
연애상담해주던 사람이 좋아지는 거 같아	인연이 거기까지인가봐요 . 
청첩장 골랐어	이렇게 고민하게 만들려고 그랬나봐요 . 
청소를 안 했더니 먼지 쌓였어	청소하세요 . 
카드 다 없애버려야지	소비 조절을 못하면 없애는 것도 방법이 될 거예요 . 
좋아하는 이상형이 계속 바뀌어.	만남에 무슨 문제가 있었나봐요 . 
어장인거 알겠는데 포기가 안돼.	신경쓰지 않는 연습을 해봐요 . 
혼인신고하니까 마음이 이상해	인연이 거기까지인가봐요 . 
차로 데려다줬는데	호감이 있을 수도 있어요 . 그렇지만 조금 더 상황을 지켜보세요 . 
양심에 찔려	저도 듣고 싶어요 . 
가족관계 알려줘	저는 저위고민
좋아하는 남자애가 여친 생기면 울 줄 알았는데 덤덤해.	가장 확실한 시간은 오늘이에요 . 어제와 내일을 놓고 고민하느라 시간을 낭비하지 마세요 . 
손 시려	아무말도 하지말고 침묵하세요 . 
나한테 너무 잘해줘서 이래도 되나 싶어	잘할 수 있을 거예요 . 
머리가 콕콕 쑤셔	머리랑 가슴이 가끔 따로 놀죠 . 
헤어진지 3주가 아직안됐네	하루 하루를 헤아리는 건 자신을 더 힘들게 만들 뿐이에요 . 
한순간에 변한 사람.그리고 예의에 대해.	그건 좀 힘들 거예요 . 
걸지 못한 전화	바쁘거나 마음이 없는걸지도 모르겠어요 . 
누군가를 좋아하는게 두려워.	서로가 전부인 연애가 아니라 서로 마음이 안되죠 . 
컨디션 조절	저도 쉬고 놀고 하고 싶어요 . 
반장을 좋아해.	많이 힘들었겠어요 . 
오늘 더 힘이 드네	내일은 더 나은 하루일 거예요 . 
프리마켓 재밌겠지	저도 딸기 좋아해요 . 
스팸 전화 많이 와	차단 어플 사용해보세요 . 
집안일 해도 해도 안 끝나	조금씩 해보세요 . 
혹시 그런 날 없나	시원한 바람 쉬고 약먹기 ! 
일 때려칠까	확신이 없나봐요 . 
어느덧 한달.	그러게요 . 어느덧 한달이에요 . 
보이스피싱 전화왔어	경찰에 신고하고 취할 수 있는 조취를 취해보세요 . 
친구가 내 썸남이랑 연락해	바쁘거나 감정의 이 연락해 주세요 . 
오늘 또 하루 살았네	오늘도 평안했던 하루에 감사하는 마음을 가져보세요 . 
죽을거같죠사람은 간사하네	언젠간 올 시기였나봐요 . 
드라마 볼 게 없어	하고싶었던 일을 글로 적어보세요 . 생각이 정리될 거예요 . 
주행 연습 끝났어	용기를 내요 ! 
3년이란 오랜기간 연애를 하다보니 권태기가 찾아오네	인연이 거기까지였나봐요 . 
썸 타는 거 시간 아까워.	고민하고 있다면 그게 맞을거예요 . 
길이 얼었어	여유를 가지세요 . 
넥타이핀 정도는 선물로 줘도 괜찮겠지	사랑의 예의가 없네요 . 
롱디인데 너무 보고 싶어.	조금만 더 버텨보세요 . 
썸 탈 때 꽃 선물 부담스러워 할까	여행카페선물" 
이별했습니다	마음 단단단히 잡을거라 생각해요 . 
여자친구 쌩얼 보고 배신감 느껴	즐거운 시간 보내시길 바랍니다 . 
부모님 선물은 뭐할까	부모님도 좋아할 거예요 . 
많이 사랑 했나보다	사랑은 따뜻한 물 한 잔 드려요 . 
남친 있는데 다른 사람이 자꾸 눈에 들어와.	그럴 수 있을 거예요 . 
잘해준것 같은데도 느끼는 미안함	잘 찾아보세요 . 
날이 꿀꾸리	괜찮아요 . 
술이 보약도 아니고	신경쓰지 않는 연습을 해봐요 . 
셀프웨딩 힘든만큼 보람될까	혼자 준비하기는 조금 벅찰텐대요 . 
서로 그냥 밑바닥을 보여준것 같아	가끔 핸드폰없이 살아보세요 . 
오늘 왠지 고백 받을 것 같음.	마음에 따라 얼마든지 바뀔 수 있어요 . 
결혼한지 반년인데 이렇게 행복해도 될까 싶어	확신이 있을 때 시작해보세요 . 
이야기하고싶다	지금도 충분해요 . 
드레스룸 만들고 싶다	차근차근 계획을 세워보세요 . 
맞춤법 많이 틀리는 사람	아무래도 좀 깨요 . 
괜찮다 나는 괜찮다	괜찮은 사람이고 괜찮아질 거예요 . 
포기하니 공허하네.	채워질 거예요 . 
내려놓을 준비 합니다	잘 견뎌낼거라 믿어요 . 
헤어지자 말한 사람도 힘들까	힘들겠지만 잘 이겨낼 수 있을 거예요 . 
비가오니까	실내 데이트요 . 
머리 용량 초과	머리랑 가슴이 가끔 따로 놀죠 . 
너무 허기지네	인연이 거기까지였나봐요 . 
친구랑 나랑 좋아하는 애가 같으면 어떡해	선생님께 도움을 청해보세요 . 
좋아하는 감정을 억제하는 방법은 뭐지.	자연스러운 현상이에요 . 
데이트하는데 무한리필만 가	서로에게 부담 없는 선물이 좋아요 . 
마음에 드는 거 같은데 고백을 왜 안 하지	고백을 안하고 사귀는 경우도 있지만 정확하게 고백해보세요 . 
좋아하는 사람에 대한 생각 비우는 방법 좀 알려줘요.	좋아하는 마음이 있으면 가능하겠죠 . 
썸도 후폭풍 옴	후폭풍은 누구에게나 와요 . 
친구들은 다 결혼했어	신경쓰지 마세요 . 
썸녀가 약속 시간을 안 지킴.	친구를 사귀어 보세요 . 
얼마만큼 사랑을 받으셨나	사랑의 예의가 없네요 . 
타이밍이 기가 막혀	여초자신시
화장 무너짐	득템 했네요 . 
힘듭니다 오늘 또 무너졌어	내일은 더 나은 하루일 거예요 . 
환경 때문에 헤어진 여자친구	후회할 자신 있나봐요 . 
말 잘하고 싶어	저도 듣고 싶어요 . 
한때는 원망하고 화났었지만	시간은 상대적이에요 . 
다 잊었는데 다시 그녀가 나타났어	마음이 헛한가봐요 . 
자격증 따야하나	따뜻한 물 한 잔 드세요 . 
연예인도 힘들겠지	스스로 경쟁해야하고 이겨야한다는 강박관념에 사로라도 깨닫는게 좋겠어요 . 
황당해서 말도 안 나와	보일러가 온수로 작동하는지 보세요 . 
가슴이 허락하질 않네.	무슨 마음인지 알겠어서 더 마음이 아프네요 . 
휴학하고 싶다.	쉬고 나면 힘이 아니에요 . 
대청소 해야지	열심히 하네요 . 
저 사람이 왜 자꾸 볼까	용기를 내서 말해보세요 . 
남자들은 이쁜 여자만 좋아할까요	선물을 주면서 솔직하고 당당당하게 고백해보세요 . 
환승이별 당했습니다 ㅎㅎㅎ	환승은 진짜 예의가 없네요 . 
좋아하는 거랑 사랑하는 건 어떻게 구분해	사랑의 예의가 없네요 . 
연애 위기인 거 같아	연애하는 것도 아니에요 . 
좋아하는 사람 앞에선 다 똑같은가봐요.	마음이 복잡하겠어요 . 
알바 구해볼까	변화를 주는 것도 좋겠죠 . 
법을 요리조리 피해가는 사람	괜찮은 사람이에요 . 
부케 어떤 꼿으로 하지	누구든 그럴 거예요 . 
썸인 거 같은데 연락 안 하면	연락이 안되면 썸이 아닐지도 모르겠네요 . 
두달이 지났네	금방 나아질 거예요 . 
헤어진지 1년 뭐하는건지ㅋ	후회하지 않을 자신이 있으면 이에요 . 
랜선 연애 어떻게 생각해	연애는 서로에게 맞춰가는 거예요 . 
남자친구가 너무 귀찮아해.	친구가 아닌가봐요 . 
내 주제를 모르고 덤빈건가	금방 지나갈 거예요 . 
예쁘니까 좋아하나	확신이 없나보세요 . 
불안해	두려워하지 않아도 돼요 . 
전남친 트라우마에 힘들어하는 여자친구.	신경쓰지 마세요 . 
돈 많은 백수 하고 싶어	돈은 쓴만큼 또 생긴다고 하던데요 . 
영화볼때 너무 목소리가 큰 남자친구가 고민	무슨 고민인지 말해주세요 . 
노처녀 히스테리	남에게 피해만 주지 않는다면 괜찮아요 . 
태몽꿨대	꿈은 현실이랑 반대예요 . 
수염 기를까	지저분해요 . 
보너스 깎였어	사소한 거라도 있을 거예요 . 
사람과의 이별은 아니구	이별을 받아들이는 것도 중요해요 . 
헤어졌지만 생각나	힘든 시간 잘 버텨내고 있길 바랄게요 . 
문득 이런생각이 들었습니다	이별을 받아들이는 것도 중요해요 . 
시선이 자꾸 느껴져	잘할 수 있을 거예요 . 
떠나려는 사람 잡는 방법	머리랑 가슴이 가끔 따로 놀죠 . 
너도 몰랐니	멋진 말이에요 . 
전 여친 생일이야	잊으세요 . 
택시비 너무 비싸	후회해도 늦었어요 . 
재회하고 딱5개월만에 헤어졌네	후회할 자신 있나봅니다 . 
결혼하는데 보통 얼마 들어	살짝 뒤돌아봐도 괜찮아요 . 
기다리지 않았다고 하지만 기다렸어	기다릴 수 있을지 마세요 . 
이별을 해야하나봐	이별을 받아들이는 것도 중요해요 . 
내 사수 너무 깐깐해	가장 확실한 시간은 오늘이에요 . 어제와 내일을 놓고 고민하느라 시간을 낭비하지 마세요 . 
오늘도 포장마차	시원하게 지낸 값이죠 . 
군대 가도 기다리겠다더니	군대 시계는 멈추지 않아요 . 
6년째 연애중	시간이 흐르는 것 처럼 마음도 흘러갈 거예요 . 
짝녀와 같이 드라이브갈껀데 어디로 갈까	직접 물어보는 게 좋을 것 같아요 . 
내가 이상한 사람같아	가장 확실한 시간은 오늘이에요 . 어제와 내일을 놓고 고민하느라 시간을 낭비하지 마세요 . 
노트북 사줘	그럴 때는 초기화하는게 속시원해요 . 
미팅 할까 말까	좋으면 좋겠네요 . 
너무 편해도 안 좋아	저도 좋아해요 . 
세뱃돈 받음	쓰지 않으면 돼요 . 
배가 너무 고파	돈을 얼른 모아야할 이유가 생겼네요 . 
이력서 쓰고 있어.	나를 포장하는게 쉽지 않죠 . 
새로운 사랑은 찾아와	좋은 사람 만날 수 있을 거예요 . 
이번 달에 결혼식 너무 많아	인연이 거기까지였나봐요 . 
오랜 연애로 여자친구가 잘 안꾸미고 나오는게 고민임.	그럴 때가 있죠 . 정신 차리세요 . 
썸 타는 중인데 너무 인기 많아서 빼앗길까봐 걱정됨.	따뜻한 물 한잔 드셔보세요 . 
그와 같은 조가 되고 싶은데 먼저 말해볼까	고민하고 있다면 그게 맞을거예요 . 
윗집 애 또 뛴다	시원하게 지낸 값이죠 . 
영양제 좀 먹을까	과식하지 말고 먹기 쉬어도 괜찮아요 . 
헤어진 남자 친구한테 전화하고 싶어	후회할 자신 있다면 연락해보세요 . 
퇴근길에 훅!하고 연락오네.	마주치지 않길 바랄게요 . 
목걸이 선물해볼까	용기를 내서 말해보세요 . 
이번 생은 처음이라서	인연이 거기까지였나봐요 . 
수도가 얼었나봐	쉬운 일이 아니라는 거 잘 살펴보세요 . 
왜 이제 찾는걸까	그렇게 생각하면 좋을 것 같아요 . 
분위기 있는 데서 데이트하고 싶어	야경이 예쁜 곳이요 . 
버스에서 매일 보는 사람	운명일지도 모르겠어요 . 
많이 괜찮아졋지만 여전히 찌질한 모습의 나	감기 조심하세요 . 
네번 헤어졌습니다	인연이 거기까지인가봐요 . 
연애의 끝은 결혼인거야	더 좋은 사람 만나실 거예요 . 
이별. 버릇고치기.	다 잘 될 거예요 . 
나 열심히 할거야	메모하는 습관을 들여보세요 . 
전여친 한테 두달만에 연락이 왔어.	남의 눈을 의식하는 사람일 거라 생각해요 . 
발목 접질렀어	꾸준히 치료하세요 . 
넘 많이 먹었다.	산책 좀 해야겠네여 . 
내일 발렌타인데이인데	가족에게 주세요 . 
아직도 힘들지만.	힘들겠지만 잘 이겨낼 수 있을 거예요 . 
동기는 진급하는데	열심히 하면 할 수 있을 거예요 . 
자꾸 후회가 되네	잠이 깨닫다니 대단하시네요 . 
여자친구가 돌아다니는걸 너무 좋아해	사람 고쳐쓰는 거 아니에요 . 
어제 술마시고 나서 기억 안나	당신은 하나밖에 없는 소중한 사람이에요 . 
편지도 다 버려야겠지	버릴 건 버려야지요 . 
이번엔 또 뭐 해 먹지	냉장고 파먹기 해보세요 . 
뒷통수 맞았어	감기 조심하세요 . 
애니 좋아하는 남자 별로임	한동안은 그럴지도 몰라요 . 
언제쯤 잊혀질까	언젠간 올 순간이었을 거예요 . 
걔는 누굴 닮아서 그런거니	쉬운 일이 아니라는 거 잘 알고 있어요 . 
꿈이 현실이었으면	은연 중에 지금의 심리죠 . 
마스크팩 대량 구매했어	잘할 수 있을 거예요 . 
좋아하는 사람이 있는데 사귀는 건 싫어.	눈치가 빠르시군요 . 
썸남이 연락이 안돼	바쁘거나 감정의 변화가 생겼을지도 모르겠어요 . 
